,Year,Braut,tegund_nams,kk,kv,samtals_utt
0,2007,Félags- og mannvísindadeild,,37,172,209
1,2007,Félags- og mannvísindadeild,Grunnnám,22,77,99
2,2007,Félags- og mannvísindadeild,Viðbótarnám,2,34,36
3,2007,Félags- og mannvísindadeild,Meistarapróf,12,61,73
4,2007,Félags- og mannvísindadeild,Doktorspróf,1,0,1
5,2007,Félagsráðgjafardeild,,0,46,46
6,2007,Félagsráðgjafardeild,Grunnnám,0,35,35
7,2007,Félagsráðgjafardeild,Viðbótarnám,0,2,2
8,2007,Félagsráðgjafardeild,Meistarapróf,0,9,9
9,2007,Félagsráðgjafardeild,Doktorspróf,0,0,0
10,2007,Hagfræðideild,,22,21,43
11,2007,Hagfræðideild,Grunnnám,17,13,30
12,2007,Hagfræðideild,Viðbótarnám,0,0,0
13,2007,Hagfræðideild,Meistarapróf,5,8,13
14,2007,Hagfræðideild,Doktorspróf,0,0,0
15,2007,Lagadeild,,69,71,140
16,2007,Lagadeild,Grunnnám,45,48,93
17,2007,Lagadeild,Viðbótarnám,10,14,24
18,2007,Lagadeild,Meistarapróf,14,9,23
19,2007,Lagadeild,Doktorspróf,0,0,0
20,2007,Stjórnmálafræðideild,,28,45,73
21,2007,Stjórnmálafræðideild,Grunnnám,19,16,35
22,2007,Stjórnmálafræðideild,Viðbótarnám,4,10,14
23,2007,Stjórnmálafræðideild,Meistarapróf,5,19,24
24,2007,Stjórnmálafræðideild,Doktorspróf,0,0,0
25,2007,Viðskiptafræðideild,,78,123,201
26,2007,Viðskiptafræðideild,Grunnnám,35,55,90
27,2007,Viðskiptafræðideild,Viðbótarnám,0,0,0
28,2007,Viðskiptafræðideild,Meistarapróf,43,68,111
29,2007,Viðskiptafræðideild,Doktorspróf,0,0,0
30,2007,Hjúkrunarfræðideild,,2,121,123
31,2007,Hjúkrunarfræðideild,Grunnnám,1,57,58
32,2007,Hjúkrunarfræðideild,Viðbótarnám,0,42,42
33,2007,Hjúkrunarfræðideild,Meistarapróf,1,22,23
34,2007,Hjúkrunarfræðideild,Doktorspróf,0,0,0
35,2007,Lyfjafræðideild,,13,29,42
36,2007,Lyfjafræðideild,Grunnnám,9,18,27
37,2007,Lyfjafræðideild,Viðbótarnám,0,0,0
38,2007,Lyfjafræðideild,Meistarapróf,4,11,15
39,2007,Lyfjafræðideild,Doktorspróf,0,0,0
40,2007,Læknadeild,,20,46,66
41,2007,Læknadeild,Grunnnám,2,11,13
42,2007,Læknadeild,Viðbótarnám,15,21,36
43,2007,Læknadeild,Meistarapróf,2,10,12
44,2007,Læknadeild,Doktorspróf,1,4,5
45,2007,Lýðheilsuvísindi,,0,0,0
46,2007,Lýðheilsuvísindi,Grunnnám,0,0,0
47,2007,Lýðheilsuvísindi,Viðbótarnám,0,0,0
48,2007,Lýðheilsuvísindi,Meistarapróf,0,0,0
49,2007,Lýðheilsuvísindi,Doktorspróf,0,0,0
50,2007,Matvæla- og næringarfræðideild,,4,8,12
51,2007,Matvæla- og næringarfræðideild,Grunnnám,1,2,3
52,2007,Matvæla- og næringarfræðideild,Viðbótarnám,0,0,0
53,2007,Matvæla- og næringarfræðideild,Meistarapróf,3,6,9
54,2007,Matvæla- og næringarfræðideild,Doktorspróf,0,0,0
55,2007,Sálfræðideild,,21,71,92
56,2007,Sálfræðideild,Grunnnám,21,60,81
57,2007,Sálfræðideild,Viðbótarnám,0,0,0
58,2007,Sálfræðideild,Meistarapróf,0,11,11
59,2007,Sálfræðideild,Doktorspróf,0,0,0
60,2007,Tannlæknadeild,,4,4,8
61,2007,Tannlæknadeild,Grunnnám,4,4,8
62,2007,Tannlæknadeild,Viðbótarnám,0,0,0
63,2007,Tannlæknadeild,Meistarapróf,0,0,0
64,2007,Tannlæknadeild,Doktorspróf,0,0,0
65,2007,"Deild erlendra tungumála, bókmennta og málvísinda",,17,55,72
66,2007,"Deild erlendra tungumála, bókmennta og málvísinda",Grunnnám,17,50,67
67,2007,"Deild erlendra tungumála, bókmennta og málvísinda",Viðbótarnám,0,0,0
68,2007,"Deild erlendra tungumála, bókmennta og málvísinda",Meistarapróf,0,5,5
69,2007,"Deild erlendra tungumála, bókmennta og málvísinda",Doktorspróf,0,0,0
70,2007,Guðfræði- og trúarbragðafræðideild,,7,31,38
71,2007,Guðfræði- og trúarbragðafræðideild,Grunnnám,3,21,24
72,2007,Guðfræði- og trúarbragðafræðideild,Viðbótarnám,2,7,9
73,2007,Guðfræði- og trúarbragðafræðideild,Meistarapróf,2,3,5
74,2007,Guðfræði- og trúarbragðafræðideild,Doktorspróf,0,0,0
75,2007,Íslensku- og menningardeild,,30,85,115
76,2007,Íslensku- og menningardeild,Grunnnám,21,73,94
77,2007,Íslensku- og menningardeild,Viðbótarnám,0,0,0
78,2007,Íslensku- og menningardeild,Meistarapróf,9,12,21
79,2007,Íslensku- og menningardeild,Doktorspróf,0,0,0
80,2007,Sagnfræði- og heimspekideild,,37,31,48
81,2007,Sagnfræði- og heimspekideild,Grunnnám,30,25,35
82,2007,Sagnfræði- og heimspekideild,Viðbótarnám,0,0,0
83,2007,Sagnfræði- og heimspekideild,Meistarapróf,7,5,12
84,2007,Sagnfræði- og heimspekideild,Doktorspróf,0,1,1
85,2007,"Íþrótta-, tómstunda- og þroskaþjálfadeild",,0,0,0
86,2007,"Íþrótta-, tómstunda- og þroskaþjálfadeild",Grunnnám,0,0,0
87,2007,"Íþrótta-, tómstunda- og þroskaþjálfadeild",Viðbótarnám,0,0,0
88,2007,"Íþrótta-, tómstunda- og þroskaþjálfadeild",Meistarapróf,0,0,0
89,2007,"Íþrótta-, tómstunda- og þroskaþjálfadeild",Doktorspróf,0,0,0
90,2007,Kennaradeild,,19,44,63
91,2007,Kennaradeild,Grunnnám,0,0,0
92,2007,Kennaradeild,Viðbótarnám,19,41,60
93,2007,Kennaradeild,Meistarapróf,0,3,3
94,2007,Kennaradeild,Doktorspróf,0,0,0
95,2007,Uppeldis- og menntunarfræðideild,,2,40,42
96,2007,Uppeldis- og menntunarfræðideild,Grunnnám,1,25,26
97,2007,Uppeldis- og menntunarfræðideild,Viðbótarnám,0,5,5
98,2007,Uppeldis- og menntunarfræðideild,Meistarapróf,1,10,11
99,2007,"Iðnaðarverkfræði-, vélaverkfræði- og tölvunarfræðideild",,66,63,129
100,2007,"Iðnaðarverkfræði-, vélaverkfræði- og tölvunarfræðideild",Grunnnám,48,32,80
101,2007,"Iðnaðarverkfræði-, vélaverkfræði- og tölvunarfræðideild",Viðbótarnám,0,0,0
102,2007,"Iðnaðarverkfræði-, vélaverkfræði- og tölvunarfræðideild",Meistarapróf,18,31,49
103,2007,"Iðnaðarverkfræði-, vélaverkfræði- og tölvunarfræðideild",Doktorspróf,0,0,0
104,2007,Jarðvísindadeild,,14,10,24
105,2007,Jarðvísindadeild,Grunnnám,9,6,15
106,2007,Jarðvísindadeild,Viðbótarnám,0,0,0
107,2007,Jarðvísindadeild,Meistarapróf,3,4,7
108,2007,Jarðvísindadeild,Doktorspróf,2,0,2
109,2007,Líf- og umhverfisvísindadeild,,23,66,89
110,2007,Líf- og umhverfisvísindadeild,Grunnnám,16,58,74
111,2007,Líf- og umhverfisvísindadeild,Viðbótarnám,0,0,0
112,2007,Líf- og umhverfisvísindadeild,Meistarapróf,7,8,15
113,2007,Líf- og umhverfisvísindadeild,Doktorspróf,0,0,0
114,2007,Umhverfis- og auðlindafræði,,2,0,2
115,2007,Umhverfis- og auðlindafræði,Grunnnám,0,0,0
116,2007,Umhverfis- og auðlindafræði,Viðbótarnám,0,0,0
117,2007,Umhverfis- og auðlindafræði,Meistarapróf,2,0,2
118,2007,Umhverfis- og auðlindafræði,Doktorspróf,0,0,0
119,2007,Rafmagns- og tölvuverkfræðideild,,33,0,33
120,2007,Rafmagns- og tölvuverkfræðideild,Grunnnám,32,0,32
121,2007,Rafmagns- og tölvuverkfræðideild,Viðbótarnám,0,0,0
122,2007,Rafmagns- og tölvuverkfræðideild,Meistarapróf,1,0,1
123,2007,Rafmagns- og tölvuverkfræðideild,Doktorspróf,0,0,0
124,2007,Raunvísindadeild,,47,12,59
125,2007,Raunvísindadeild,Grunnnám,41,10,51
126,2007,Raunvísindadeild,Viðbótarnám,1,1,2
127,2007,Raunvísindadeild,Meistarapróf,5,1,6
128,2007,Raunvísindadeild,Doktorspróf,0,0,0
129,2007,Umhverfis- og byggingaverkfræðideild,,15,11,26
130,2007,Umhverfis- og byggingaverkfræðideild,Grunnnám,9,9,18
131,2007,Umhverfis- og byggingaverkfræðideild,Viðbótarnám,0,0,0
132,2007,Umhverfis- og byggingaverkfræðideild,Meistarapróf,6,2,8
133,2007,Umhverfis- og byggingaverkfræðideild,Doktorspróf,0,0,0
134,2008,Félags- og mannvísindadeild,,25,143,168
135,2008,Félags- og mannvísindadeild,Grunnnám,17,65,82
136,2008,Félags- og mannvísindadeild,Viðbótarnám,1,51,52
137,2008,Félags- og mannvísindadeild,Meistarapróf,7,27,34
138,2008,Félags- og mannvísindadeild,Doktorspróf,0,0,0
139,2008,Félagsráðgjafardeild,,4,81,85
140,2008,Félagsráðgjafardeild,Grunnnám,2,64,66
141,2008,Félagsráðgjafardeild,Viðbótarnám,2,9,11
142,2008,Félagsráðgjafardeild,Meistarapróf,0,8,8
143,2008,Félagsráðgjafardeild,Doktorspróf,0,0,0
144,2008,Hagfræðideild,,33,19,52
145,2008,Hagfræðideild,Grunnnám,31,15,46
146,2008,Hagfræðideild,Viðbótarnám,0,0,0
147,2008,Hagfræðideild,Meistarapróf,2,4,6
148,2008,Hagfræðideild,Doktorspróf,0,0,0
149,2008,Lagadeild,,66,72,138
150,2008,Lagadeild,Grunnnám,42,42,84
151,2008,Lagadeild,Viðbótarnám,0,0,0
152,2008,Lagadeild,Meistarapróf,24,30,54
153,2008,Lagadeild,Doktorspróf,0,0,0
154,2008,Stjórnmálafræðideild,,43,78,121
155,2008,Stjórnmálafræðideild,Grunnnám,16,21,37
156,2008,Stjórnmálafræðideild,Viðbótarnám,7,30,37
157,2008,Stjórnmálafræðideild,Meistarapróf,19,27,46
158,2008,Stjórnmálafræðideild,Doktorspróf,1,0,1
159,2008,Viðskiptafræðideild,,83,97,180
160,2008,Viðskiptafræðideild,Grunnnám,35,30,65
161,2008,Viðskiptafræðideild,Viðbótarnám,0,0,0
162,2008,Viðskiptafræðideild,Meistarapróf,48,67,115
163,2008,Viðskiptafræðideild,Doktorspróf,0,0,0
164,2008,Hjúkrunarfræðideild,,1,108,109
165,2008,Hjúkrunarfræðideild,Grunnnám,0,68,68
166,2008,Hjúkrunarfræðideild,Viðbótarnám,1,33,34
167,2008,Hjúkrunarfræðideild,Meistarapróf,0,0,0
168,2008,Hjúkrunarfræðideild,Doktorspróf,0,7,7
169,2008,Lyfjafræðideild,,15,36,51
170,2008,Lyfjafræðideild,Grunnnám,8,22,30
171,2008,Lyfjafræðideild,Viðbótarnám,0,0,0
172,2008,Lyfjafræðideild,Meistarapróf,7,14,21
173,2008,Lyfjafræðideild,Doktorspróf,0,0,0
174,2008,Læknadeild,,35,56,91
175,2008,Læknadeild,Grunnnám,5,15,20
176,2008,Læknadeild,Viðbótarnám,0,0,0
177,2008,Læknadeild,Meistarapróf,28,36,64
178,2008,Læknadeild,Doktorspróf,2,5,7
179,2008,Lýðheilsuvísindi,,1,0,1
180,2008,Lýðheilsuvísindi,Grunnnám,0,0,0
181,2008,Lýðheilsuvísindi,Viðbótarnám,0,0,0
182,2008,Lýðheilsuvísindi,Meistarapróf,1,0,1
183,2008,Lýðheilsuvísindi,Doktorspróf,0,0,0
184,2008,Matvæla- og næringarfræðideild,,0,0,0
185,2008,Matvæla- og næringarfræðideild,Grunnnám,0,0,0
186,2008,Matvæla- og næringarfræðideild,Viðbótarnám,0,0,0
187,2008,Matvæla- og næringarfræðideild,Meistarapróf,0,0,0
188,2008,Matvæla- og næringarfræðideild,Doktorspróf,0,0,0
189,2008,Sálfræðideild,,19,83,102
190,2008,Sálfræðideild,Grunnnám,16,69,85
191,2008,Sálfræðideild,Viðbótarnám,0,0,0
192,2008,Sálfræðideild,Meistarapróf,3,14,17
193,2008,Sálfræðideild,Doktorspróf,0,0,0
194,2008,Tannlæknadeild,,2,4,6
195,2008,Tannlæknadeild,Grunnnám,2,4,6
196,2008,Tannlæknadeild,Viðbótarnám,0,0,0
197,2008,Tannlæknadeild,Meistarapróf,0,0,0
198,2008,Tannlæknadeild,Doktorspróf,0,0,0
199,2008,"Deild erlendra tungumála, bókmennta og málvísinda",,18,55,73
200,2008,"Deild erlendra tungumála, bókmennta og málvísinda",Grunnnám,17,47,64
201,2008,"Deild erlendra tungumála, bókmennta og málvísinda",Viðbótarnám,0,0,0
202,2008,"Deild erlendra tungumála, bókmennta og málvísinda",Meistarapróf,1,8,9
203,2008,"Deild erlendra tungumála, bókmennta og málvísinda",Doktorspróf,0,0,0
204,2008,Guðfræði- og trúarbragðafræðideild,,9,20,29
205,2008,Guðfræði- og trúarbragðafræðideild,Grunnnám,3,10,13
206,2008,Guðfræði- og trúarbragðafræðideild,Viðbótarnám,5,10,15
207,2008,Guðfræði- og trúarbragðafræðideild,Meistarapróf,1,0,1
208,2008,Guðfræði- og trúarbragðafræðideild,Doktorspróf,0,0,0
209,2008,Íslensku- og menningardeild,,28,77,105
210,2008,Íslensku- og menningardeild,Grunnnám,21,64,85
211,2008,Íslensku- og menningardeild,Viðbótarnám,1,2,3
212,2008,Íslensku- og menningardeild,Meistarapróf,6,11,17
213,2008,Íslensku- og menningardeild,Doktorspróf,0,0,0
214,2008,Sagnfræði- og heimspekideild,,29,42,60
215,2008,Sagnfræði- og heimspekideild,Grunnnám,24,22,35
216,2008,Sagnfræði- og heimspekideild,Viðbótarnám,0,0,0
217,2008,Sagnfræði- og heimspekideild,Meistarapróf,5,20,25
218,2008,Sagnfræði- og heimspekideild,Doktorspróf,0,0,0
219,2008,"Íþrótta-, tómstunda- og þroskaþjálfadeild",,1,12,13
220,2008,"Íþrótta-, tómstunda- og þroskaþjálfadeild",Grunnnám,1,12,13
221,2008,"Íþrótta-, tómstunda- og þroskaþjálfadeild",Viðbótarnám,0,0,0
222,2008,"Íþrótta-, tómstunda- og þroskaþjálfadeild",Meistarapróf,0,0,0
223,2008,"Íþrótta-, tómstunda- og þroskaþjálfadeild",Doktorspróf,0,0,0
224,2008,Kennaradeild,,12,60,72
225,2008,Kennaradeild,Grunnnám,3,14,17
226,2008,Kennaradeild,Viðbótarnám,8,43,51
227,2008,Kennaradeild,Meistarapróf,1,3,4
228,2008,Kennaradeild,Doktorspróf,0,0,0
229,2008,Uppeldis- og menntunarfræðideild,,3,38,41
230,2008,Uppeldis- og menntunarfræðideild,Grunnnám,2,20,22
231,2008,Uppeldis- og menntunarfræðideild,Viðbótarnám,0,8,8
232,2008,Uppeldis- og menntunarfræðideild,Meistarapróf,1,10,11
233,2008,Uppeldis- og menntunarfræðideild,Doktorspróf,0,0,0
234,2008,"Iðnaðarverkfræði-, vélaverkfræði- og tölvunarfræðideild",,81,38,119
235,2008,"Iðnaðarverkfræði-, vélaverkfræði- og tölvunarfræðideild",Grunnnám,50,19,69
236,2008,"Iðnaðarverkfræði-, vélaverkfræði- og tölvunarfræðideild",Viðbótarnám,0,0,0
237,2008,"Iðnaðarverkfræði-, vélaverkfræði- og tölvunarfræðideild",Meistarapróf,28,19,47
238,2008,"Iðnaðarverkfræði-, vélaverkfræði- og tölvunarfræðideild",Doktorspróf,3,0,3
239,2008,Jarðvísindadeild,,10,7,17
240,2008,Jarðvísindadeild,Grunnnám,9,3,12
241,2008,Jarðvísindadeild,Viðbótarnám,0,0,0
242,2008,Jarðvísindadeild,Meistarapróf,1,4,5
243,2008,Jarðvísindadeild,Doktorspróf,0,0,0
244,2008,Líf- og umhverfisvísindadeild,,24,76,100
245,2008,Líf- og umhverfisvísindadeild,Grunnnám,18,64,82
246,2008,Líf- og umhverfisvísindadeild,Viðbótarnám,0,0,0
247,2008,Líf- og umhverfisvísindadeild,Meistarapróf,3,12,15
248,2008,Líf- og umhverfisvísindadeild,Doktorspróf,3,0,3
249,2008,Umhverfis- og auðlindafræði,,2,3,5
250,2008,Umhverfis- og auðlindafræði,Grunnnám,0,0,0
251,2008,Umhverfis- og auðlindafræði,Viðbótarnám,0,0,0
252,2008,Umhverfis- og auðlindafræði,Meistarapróf,2,3,5
253,2008,Umhverfis- og auðlindafræði,Doktorspróf,0,0,0
254,2008,Rafmagns- og tölvuverkfræðideild,,15,3,18
255,2008,Rafmagns- og tölvuverkfræðideild,Grunnnám,11,3,14
256,2008,Rafmagns- og tölvuverkfræðideild,Viðbótarnám,0,0,0
257,2008,Rafmagns- og tölvuverkfræðideild,Meistarapróf,3,0,3
258,2008,Rafmagns- og tölvuverkfræðideild,Doktorspróf,1,0,1
259,2008,Raunvísindadeild,,35,20,55
260,2008,Raunvísindadeild,Grunnnám,28,17,45
261,2008,Raunvísindadeild,Viðbótarnám,0,0,0
262,2008,Raunvísindadeild,Meistarapróf,6,3,9
263,2008,Raunvísindadeild,Doktorspróf,1,0,1
264,2008,Umhverfis- og byggingaverkfræðideild,,15,20,35
265,2008,Umhverfis- og byggingaverkfræðideild,Grunnnám,13,16,29
266,2008,Umhverfis- og byggingaverkfræðideild,Viðbótarnám,0,0,0
267,2008,Umhverfis- og byggingaverkfræðideild,Meistarapróf,1,4,5
268,2008,Umhverfis- og byggingaverkfræðideild,Doktorspróf,1,0,1
269,2009,Félags- og mannvísindadeild,,26,181,207
270,2009,Félags- og mannvísindadeild,Grunnnám,4,102,106
271,2009,Félags- og mannvísindadeild,Viðbótarnám,8,33,41
272,2009,Félags- og mannvísindadeild,Meistarapróf,14,44,58
273,2009,Félags- og mannvísindadeild,Doktorspróf,0,2,2
274,2009,Félagsráðgjafardeild,,12,78,90
275,2009,Félagsráðgjafardeild,Grunnnám,10,58,68
276,2009,Félagsráðgjafardeild,Viðbótarnám,2,8,10
277,2009,Félagsráðgjafardeild,Meistarapróf,0,12,12
278,2009,Félagsráðgjafardeild,Doktorspróf,0,0,0
279,2009,Hagfræðideild,,12,11,23
280,2009,Hagfræðideild,Grunnnám,5,3,8
281,2009,Hagfræðideild,Viðbótarnám,0,0,0
282,2009,Hagfræðideild,Meistarapróf,7,8,15
283,2009,Hagfræðideild,Doktorspróf,0,0,0
284,2009,Lagadeild,,66,79,145
285,2009,Lagadeild,Grunnnám,26,45,71
286,2009,Lagadeild,Viðbótarnám,0,0,0
287,2009,Lagadeild,Meistarapróf,39,34,73
288,2009,Lagadeild,Doktorspróf,1,0,1
289,2009,Stjórnmálafræðideild,,47,76,123
290,2009,Stjórnmálafræðideild,Grunnnám,27,22,49
291,2009,Stjórnmálafræðideild,Viðbótarnám,7,31,38
292,2009,Stjórnmálafræðideild,Meistarapróf,12,21,33
293,2009,Stjórnmálafræðideild,Doktorspróf,1,2,3
294,2009,Viðskiptafræðideild,,75,108,183
295,2009,Viðskiptafræðideild,Grunnnám,28,32,60
296,2009,Viðskiptafræðideild,Viðbótarnám,0,0,0
297,2009,Viðskiptafræðideild,Meistarapróf,47,76,123
298,2009,Viðskiptafræðideild,Doktorspróf,0,0,0
299,2009,Hjúkrunarfræðideild,,2,131,133
300,2009,Hjúkrunarfræðideild,Grunnnám,1,65,66
301,2009,Hjúkrunarfræðideild,Viðbótarnám,0,44,44
302,2009,Hjúkrunarfræðideild,Meistarapróf,1,21,22
303,2009,Hjúkrunarfræðideild,Doktorspróf,0,1,1
304,2009,Lyfjafræðideild,,13,32,45
305,2009,Lyfjafræðideild,Grunnnám,5,16,21
306,2009,Lyfjafræðideild,Viðbótarnám,0,0,0
307,2009,Lyfjafræðideild,Meistarapróf,7,16,23
308,2009,Lyfjafræðideild,Doktorspróf,1,0,1
309,2009,Læknadeild,,30,64,94
310,2009,Læknadeild,Grunnnám,10,26,36
311,2009,Læknadeild,Viðbótarnám,0,7,7
312,2009,Læknadeild,Meistarapróf,18,28,46
313,2009,Læknadeild,Doktorspróf,2,3,5
314,2009,Lýðheilsuvísindi,,0,0,0
315,2009,Lýðheilsuvísindi,Grunnnám,0,0,0
316,2009,Lýðheilsuvísindi,Viðbótarnám,0,0,0
317,2009,Lýðheilsuvísindi,Meistarapróf,0,0,0
318,2009,Lýðheilsuvísindi,Doktorspróf,0,0,0
319,2009,Matvæla- og næringarfræðideild,,2,6,8
320,2009,Matvæla- og næringarfræðideild,Grunnnám,0,1,1
321,2009,Matvæla- og næringarfræðideild,Viðbótarnám,0,0,0
322,2009,Matvæla- og næringarfræðideild,Meistarapróf,2,2,4
323,2009,Matvæla- og næringarfræðideild,Doktorspróf,0,3,3
324,2009,Sálfræðideild,,22,73,95
325,2009,Sálfræðideild,Grunnnám,17,55,72
326,2009,Sálfræðideild,Viðbótarnám,0,0,0
327,2009,Sálfræðideild,Meistarapróf,4,18,22
328,2009,Sálfræðideild,Doktorspróf,1,0,1
329,2009,Tannlæknadeild,,4,2,6
330,2009,Tannlæknadeild,Grunnnám,4,2,6
331,2009,Tannlæknadeild,Viðbótarnám,0,0,0
332,2009,Tannlæknadeild,Meistarapróf,0,0,0
333,2009,Tannlæknadeild,Doktorspróf,0,0,0
334,2009,"Deild erlendra tungumála, bókmennta og málvísinda",,16,49,65
335,2009,"Deild erlendra tungumála, bókmennta og málvísinda",Grunnnám,14,41,55
336,2009,"Deild erlendra tungumála, bókmennta og málvísinda",Viðbótarnám,0,0,0
337,2009,"Deild erlendra tungumála, bókmennta og málvísinda",Meistarapróf,2,8,10
338,2009,"Deild erlendra tungumála, bókmennta og málvísinda",Doktorspróf,0,0,0
339,2009,Guðfræði- og trúarbragðafræðideild,,6,10,16
340,2009,Guðfræði- og trúarbragðafræðideild,Grunnnám,6,8,14
341,2009,Guðfræði- og trúarbragðafræðideild,Viðbótarnám,0,2,2
342,2009,Guðfræði- og trúarbragðafræðideild,Meistarapróf,0,0,0
343,2009,Guðfræði- og trúarbragðafræðideild,Doktorspróf,0,0,0
344,2009,Íslensku- og menningardeild,,26,88,114
345,2009,Íslensku- og menningardeild,Grunnnám,15,62,77
346,2009,Íslensku- og menningardeild,Viðbótarnám,0,1,1
347,2009,Íslensku- og menningardeild,Meistarapróf,10,24,34
348,2009,Íslensku- og menningardeild,Doktorspróf,1,1,2
349,2009,Sagnfræði- og heimspekideild,,40,33,57
350,2009,Sagnfræði- og heimspekideild,Grunnnám,32,19,35
351,2009,Sagnfræði- og heimspekideild,Viðbótarnám,0,0,0
352,2009,Sagnfræði- og heimspekideild,Meistarapróf,8,13,21
353,2009,Sagnfræði- og heimspekideild,Doktorspróf,0,1,1
354,2009,"Íþrótta-, tómstunda- og þroskaþjálfadeild",,27,95,122
355,2009,"Íþrótta-, tómstunda- og þroskaþjálfadeild",Grunnnám,15,59,74
356,2009,"Íþrótta-, tómstunda- og þroskaþjálfadeild",Viðbótarnám,2,14,16
357,2009,"Íþrótta-, tómstunda- og þroskaþjálfadeild",Meistarapróf,10,22,32
358,2009,"Íþrótta-, tómstunda- og þroskaþjálfadeild",Doktorspróf,0,0,0
359,2009,Kennaradeild,,44,297,341
360,2009,Kennaradeild,Grunnnám,18,201,219
361,2009,Kennaradeild,Viðbótarnám,23,79,102
362,2009,Kennaradeild,Meistarapróf,3,17,20
363,2009,Kennaradeild,Doktorspróf,0,0,0
364,2009,Uppeldis- og menntunarfræðideild,,9,83,92
365,2009,Uppeldis- og menntunarfræðideild,Grunnnám,7,46,53
366,2009,Uppeldis- og menntunarfræðideild,Viðbótarnám,0,3,3
367,2009,Uppeldis- og menntunarfræðideild,Meistarapróf,2,33,35
368,2009,Uppeldis- og menntunarfræðideild,Doktorspróf,0,1,1
369,2009,"Iðnaðarverkfræði-, vélaverkfræði- og tölvunarfræðideild",,69,43,112
370,2009,"Iðnaðarverkfræði-, vélaverkfræði- og tölvunarfræðideild",Grunnnám,39,15,54
371,2009,"Iðnaðarverkfræði-, vélaverkfræði- og tölvunarfræðideild",Viðbótarnám,0,0,0
372,2009,"Iðnaðarverkfræði-, vélaverkfræði- og tölvunarfræðideild",Meistarapróf,30,28,58
373,2009,"Iðnaðarverkfræði-, vélaverkfræði- og tölvunarfræðideild",Doktorspróf,0,0,0
374,2009,Jarðvísindadeild,,9,16,25
375,2009,Jarðvísindadeild,Grunnnám,2,7,9
376,2009,Jarðvísindadeild,Viðbótarnám,0,3,3
377,2009,Jarðvísindadeild,Meistarapróf,7,3,10
378,2009,Jarðvísindadeild,Doktorspróf,0,3,3
379,2009,Líf- og umhverfisvísindadeild,,20,46,66
380,2009,Líf- og umhverfisvísindadeild,Grunnnám,15,43,58
381,2009,Líf- og umhverfisvísindadeild,Viðbótarnám,1,0,1
382,2009,Líf- og umhverfisvísindadeild,Meistarapróf,4,2,6
383,2009,Líf- og umhverfisvísindadeild,Doktorspróf,0,1,1
384,2009,Umhverfis- og auðlindafræði,,1,5,6
385,2009,Umhverfis- og auðlindafræði,Grunnnám,0,0,0
386,2009,Umhverfis- og auðlindafræði,Viðbótarnám,0,0,0
387,2009,Umhverfis- og auðlindafræði,Meistarapróf,1,5,6
388,2009,Umhverfis- og auðlindafræði,Doktorspróf,0,0,0
389,2009,Rafmagns- og tölvuverkfræðideild,,17,2,19
390,2009,Rafmagns- og tölvuverkfræðideild,Grunnnám,15,2,17
391,2009,Rafmagns- og tölvuverkfræðideild,Viðbótarnám,0,0,0
392,2009,Rafmagns- og tölvuverkfræðideild,Meistarapróf,2,0,2
393,2009,Rafmagns- og tölvuverkfræðideild,Doktorspróf,0,0,0
394,2009,Raunvísindadeild,,33,12,45
395,2009,Raunvísindadeild,Grunnnám,24,12,36
396,2009,Raunvísindadeild,Viðbótarnám,0,0,0
397,2009,Raunvísindadeild,Meistarapróf,6,0,6
398,2009,Raunvísindadeild,Doktorspróf,3,0,3
399,2009,Umhverfis- og byggingaverkfræðideild,,19,10,29
400,2009,Umhverfis- og byggingaverkfræðideild,Grunnnám,14,8,22
401,2009,Umhverfis- og byggingaverkfræðideild,Viðbótarnám,0,0,0
402,2009,Umhverfis- og byggingaverkfræðideild,Meistarapróf,5,2,7
403,2009,Umhverfis- og byggingaverkfræðideild,Doktorspróf,0,0,0
404,2010,Félags- og mannvísindadeild,,29,177,206
405,2010,Félags- og mannvísindadeild,Grunnnám,11,66,77
406,2010,Félags- og mannvísindadeild,Viðbótarnám,6,66,72
407,2010,Félags- og mannvísindadeild,Meistarapróf,12,45,57
408,2010,Félags- og mannvísindadeild,Doktorspróf,0,0,0
409,2010,Félagsráðgjafardeild,,8,91,99
410,2010,Félagsráðgjafardeild,Grunnnám,6,53,59
411,2010,Félagsráðgjafardeild,Viðbótarnám,2,17,19
412,2010,Félagsráðgjafardeild,Meistarapróf,0,21,21
413,2010,Félagsráðgjafardeild,Doktorspróf,0,0,0
414,2010,Hagfræðideild,,39,27,66
415,2010,Hagfræðideild,Grunnnám,20,15,35
416,2010,Hagfræðideild,Viðbótarnám,0,1,1
417,2010,Hagfræðideild,Meistarapróf,19,11,30
418,2010,Hagfræðideild,Doktorspróf,0,0,0
419,2010,Lagadeild,,78,87,165
420,2010,Lagadeild,Grunnnám,38,32,70
421,2010,Lagadeild,Viðbótarnám,0,1,1
422,2010,Lagadeild,Meistarapróf,40,54,94
423,2010,Lagadeild,Doktorspróf,0,0,0
424,2010,Stjórnmálafræðideild,,51,66,117
425,2010,Stjórnmálafræðideild,Grunnnám,26,20,46
426,2010,Stjórnmálafræðideild,Viðbótarnám,11,27,38
427,2010,Stjórnmálafræðideild,Meistarapróf,14,19,33
428,2010,Stjórnmálafræðideild,Doktorspróf,0,0,0
429,2010,Viðskiptafræðideild,,99,151,250
430,2010,Viðskiptafræðideild,Grunnnám,38,51,89
431,2010,Viðskiptafræðideild,Viðbótarnám,1,1,2
432,2010,Viðskiptafræðideild,Meistarapróf,59,99,158
433,2010,Viðskiptafræðideild,Doktorspróf,1,0,1
434,2010,Hjúkrunarfræðideild,,6,140,146
435,2010,Hjúkrunarfræðideild,Grunnnám,4,76,80
436,2010,Hjúkrunarfræðideild,Viðbótarnám,1,43,44
437,2010,Hjúkrunarfræðideild,Meistarapróf,1,21,22
438,2010,Hjúkrunarfræðideild,Doktorspróf,0,0,0
439,2010,Lyfjafræðideild,,13,33,46
440,2010,Lyfjafræðideild,Grunnnám,7,15,22
441,2010,Lyfjafræðideild,Viðbótarnám,0,0,0
442,2010,Lyfjafræðideild,Meistarapróf,5,18,23
443,2010,Lyfjafræðideild,Doktorspróf,1,0,1
444,2010,Læknadeild,,52,109,161
445,2010,Læknadeild,Grunnnám,42,74,116
446,2010,Læknadeild,Viðbótarnám,0,14,14
447,2010,Læknadeild,Meistarapróf,8,16,24
448,2010,Læknadeild,Doktorspróf,2,5,7
449,2010,Lýðheilsuvísindi,,0,0,0
450,2010,Lýðheilsuvísindi,Grunnnám,0,0,0
451,2010,Lýðheilsuvísindi,Viðbótarnám,0,0,0
452,2010,Lýðheilsuvísindi,Meistarapróf,0,0,0
453,2010,Lýðheilsuvísindi,Doktorspróf,0,0,0
454,2010,Matvæla- og næringarfræðideild,,4,12,16
455,2010,Matvæla- og næringarfræðideild,Grunnnám,2,6,8
456,2010,Matvæla- og næringarfræðideild,Viðbótarnám,0,1,1
457,2010,Matvæla- og næringarfræðideild,Meistarapróf,0,4,4
458,2010,Matvæla- og næringarfræðideild,Doktorspróf,2,1,3
459,2010,Sálfræðideild,,17,65,82
460,2010,Sálfræðideild,Grunnnám,10,51,61
461,2010,Sálfræðideild,Viðbótarnám,0,0,0
462,2010,Sálfræðideild,Meistarapróf,7,14,21
463,2010,Sálfræðideild,Doktorspróf,0,0,0
464,2010,Tannlæknadeild,,3,6,9
465,2010,Tannlæknadeild,Grunnnám,2,6,8
466,2010,Tannlæknadeild,Viðbótarnám,0,0,0
467,2010,Tannlæknadeild,Meistarapróf,1,0,1
468,2010,Tannlæknadeild,Doktorspróf,0,0,0
469,2010,"Deild erlendra tungumála, bókmennta og málvísinda",,19,78,97
470,2010,"Deild erlendra tungumála, bókmennta og málvísinda",Grunnnám,19,70,89
471,2010,"Deild erlendra tungumála, bókmennta og málvísinda",Viðbótarnám,0,0,0
472,2010,"Deild erlendra tungumála, bókmennta og málvísinda",Meistarapróf,0,8,8
473,2010,"Deild erlendra tungumála, bókmennta og málvísinda",Doktorspróf,0,0,0
474,2010,Guðfræði- og trúarbragðafræðideild,,4,15,19
475,2010,Guðfræði- og trúarbragðafræðideild,Grunnnám,4,9,13
476,2010,Guðfræði- og trúarbragðafræðideild,Viðbótarnám,0,6,6
477,2010,Guðfræði- og trúarbragðafræðideild,Meistarapróf,0,0,0
478,2010,Guðfræði- og trúarbragðafræðideild,Doktorspróf,0,0,0
479,2010,Íslensku- og menningardeild,,31,90,121
480,2010,Íslensku- og menningardeild,Grunnnám,19,68,87
481,2010,Íslensku- og menningardeild,Viðbótarnám,1,1,2
482,2010,Íslensku- og menningardeild,Meistarapróf,10,21,31
483,2010,Íslensku- og menningardeild,Doktorspróf,1,0,1
484,2010,Sagnfræði- og heimspekideild,,23,103,59
485,2010,Sagnfræði- og heimspekideild,Grunnnám,18,84,35
486,2010,Sagnfræði- og heimspekideild,Viðbótarnám,0,0,0
487,2010,Sagnfræði- og heimspekideild,Meistarapróf,5,18,23
488,2010,Sagnfræði- og heimspekideild,Doktorspróf,0,1,1
489,2010,"Íþrótta-, tómstunda- og þroskaþjálfadeild",,21,90,111
490,2010,"Íþrótta-, tómstunda- og þroskaþjálfadeild",Grunnnám,18,84,102
491,2010,"Íþrótta-, tómstunda- og þroskaþjálfadeild",Viðbótarnám,3,6,9
492,2010,"Íþrótta-, tómstunda- og þroskaþjálfadeild",Meistarapróf,0,0,0
493,2010,"Íþrótta-, tómstunda- og þroskaþjálfadeild",Doktorspróf,0,0,0
494,2010,Kennaradeild,,69,373,442
495,2010,Kennaradeild,Grunnnám,44,276,320
496,2010,Kennaradeild,Viðbótarnám,23,76,99
497,2010,Kennaradeild,Meistarapróf,2,21,23
498,2010,Kennaradeild,Doktorspróf,0,0,0
499,2010,Uppeldis- og menntunarfræðideild,,8,66,74
500,2010,Uppeldis- og menntunarfræðideild,Grunnnám,1,17,18
501,2010,Uppeldis- og menntunarfræðideild,Viðbótarnám,2,15,17
502,2010,Uppeldis- og menntunarfræðideild,Meistarapróf,5,33,38
503,2010,Uppeldis- og menntunarfræðideild,Doktorspróf,0,1,1
504,2010,"Iðnaðarverkfræði-, vélaverkfræði- og tölvunarfræðideild",,79,52,131
505,2010,"Iðnaðarverkfræði-, vélaverkfræði- og tölvunarfræðideild",Grunnnám,51,26,77
506,2010,"Iðnaðarverkfræði-, vélaverkfræði- og tölvunarfræðideild",Viðbótarnám,0,0,0
507,2010,"Iðnaðarverkfræði-, vélaverkfræði- og tölvunarfræðideild",Meistarapróf,27,26,53
508,2010,"Iðnaðarverkfræði-, vélaverkfræði- og tölvunarfræðideild",Doktorspróf,1,0,1
509,2010,Jarðvísindadeild,,10,16,26
510,2010,Jarðvísindadeild,Grunnnám,2,9,11
511,2010,Jarðvísindadeild,Viðbótarnám,0,0,0
512,2010,Jarðvísindadeild,Meistarapróf,7,5,12
513,2010,Jarðvísindadeild,Doktorspróf,1,2,3
514,2010,Líf- og umhverfisvísindadeild,,29,56,85
515,2010,Líf- og umhverfisvísindadeild,Grunnnám,20,45,65
516,2010,Líf- og umhverfisvísindadeild,Viðbótarnám,0,1,1
517,2010,Líf- og umhverfisvísindadeild,Meistarapróf,6,7,13
518,2010,Líf- og umhverfisvísindadeild,Doktorspróf,3,3,6
519,2010,Umhverfis- og auðlindafræði,,17,25,42
520,2010,Umhverfis- og auðlindafræði,Grunnnám,14,2,16
521,2010,Umhverfis- og auðlindafræði,Viðbótarnám,0,5,5
522,2010,Umhverfis- og auðlindafræði,Meistarapróf,3,18,21
523,2010,Umhverfis- og auðlindafræði,Doktorspróf,0,0,0
524,2010,Rafmagns- og tölvuverkfræðideild,,4,10,14
525,2010,Rafmagns- og tölvuverkfræðideild,Grunnnám,2,9,11
526,2010,Rafmagns- og tölvuverkfræðideild,Viðbótarnám,1,0,1
527,2010,Rafmagns- og tölvuverkfræðideild,Meistarapróf,0,0,0
528,2010,Rafmagns- og tölvuverkfræðideild,Doktorspróf,1,1,2
529,2010,Raunvísindadeild,,32,22,54
530,2010,Raunvísindadeild,Grunnnám,18,15,33
531,2010,Raunvísindadeild,Viðbótarnám,0,0,0
532,2010,Raunvísindadeild,Meistarapróf,7,6,13
533,2010,Raunvísindadeild,Doktorspróf,7,1,8
534,2010,Umhverfis- og byggingaverkfræðideild,,24,14,38
535,2010,Umhverfis- og byggingaverkfræðideild,Grunnnám,19,11,30
536,2010,Umhverfis- og byggingaverkfræðideild,Viðbótarnám,0,0,0
537,2010,Umhverfis- og byggingaverkfræðideild,Meistarapróf,4,3,7
538,2010,Umhverfis- og byggingaverkfræðideild,Doktorspróf,1,0,1
539,2011,Félags- og mannvísindadeild,,25,145,170
540,2011,Félags- og mannvísindadeild,Grunnnám,13,61,74
541,2011,Félags- og mannvísindadeild,Viðbótarnám,4,24,28
542,2011,Félags- og mannvísindadeild,Meistarapróf,8,59,67
543,2011,Félags- og mannvísindadeild,Doktorspróf,0,1,1
544,2011,Félagsráðgjafardeild,,2,66,68
545,2011,Félagsráðgjafardeild,Grunnnám,2,44,46
546,2011,Félagsráðgjafardeild,Viðbótarnám,0,7,7
547,2011,Félagsráðgjafardeild,Meistarapróf,0,15,15
548,2011,Félagsráðgjafardeild,Doktorspróf,0,0,0
549,2011,Hagfræðideild,,23,23,46
550,2011,Hagfræðideild,Grunnnám,16,14,30
551,2011,Hagfræðideild,Viðbótarnám,0,0,0
552,2011,Hagfræðideild,Meistarapróf,7,9,16
553,2011,Hagfræðideild,Doktorspróf,0,0,0
554,2011,Lagadeild,,62,74,136
555,2011,Lagadeild,Grunnnám,35,38,73
556,2011,Lagadeild,Viðbótarnám,0,0,0
557,2011,Lagadeild,Meistarapróf,26,36,62
558,2011,Lagadeild,Doktorspróf,1,0,1
559,2011,Stjórnmálafræðideild,,46,99,145
560,2011,Stjórnmálafræðideild,Grunnnám,13,30,43
561,2011,Stjórnmálafræðideild,Viðbótarnám,17,34,51
562,2011,Stjórnmálafræðideild,Meistarapróf,15,35,50
563,2011,Stjórnmálafræðideild,Doktorspróf,1,0,1
564,2011,Viðskiptafræðideild,,109,153,262
565,2011,Viðskiptafræðideild,Grunnnám,41,52,93
566,2011,Viðskiptafræðideild,Viðbótarnám,0,0,0
567,2011,Viðskiptafræðideild,Meistarapróf,67,101,168
568,2011,Viðskiptafræðideild,Doktorspróf,1,0,1
569,2011,Hjúkrunarfræðideild,,3,96,99
570,2011,Hjúkrunarfræðideild,Grunnnám,3,71,74
571,2011,Hjúkrunarfræðideild,Viðbótarnám,0,6,6
572,2011,Hjúkrunarfræðideild,Meistarapróf,0,19,19
573,2011,Hjúkrunarfræðideild,Doktorspróf,0,0,0
574,2011,Lyfjafræðideild,,10,22,32
575,2011,Lyfjafræðideild,Grunnnám,4,10,14
576,2011,Lyfjafræðideild,Viðbótarnám,0,0,0
577,2011,Lyfjafræðideild,Meistarapróf,5,11,16
578,2011,Lyfjafræðideild,Doktorspróf,1,1,2
579,2011,Læknadeild,,46,106,152
580,2011,Læknadeild,Grunnnám,41,76,117
581,2011,Læknadeild,Viðbótarnám,1,10,11
582,2011,Læknadeild,Meistarapróf,0,15,15
583,2011,Læknadeild,Doktorspróf,4,5,9
584,2011,Lýðheilsuvísindi,,1,23,24
585,2011,Lýðheilsuvísindi,Grunnnám,0,0,0
586,2011,Lýðheilsuvísindi,Viðbótarnám,0,8,8
587,2011,Lýðheilsuvísindi,Meistarapróf,1,14,15
588,2011,Lýðheilsuvísindi,Doktorspróf,0,1,1
589,2011,Matvæla- og næringarfræðideild,,3,13,16
590,2011,Matvæla- og næringarfræðideild,Grunnnám,0,7,7
591,2011,Matvæla- og næringarfræðideild,Viðbótarnám,0,0,0
592,2011,Matvæla- og næringarfræðideild,Meistarapróf,2,5,7
593,2011,Matvæla- og næringarfræðideild,Doktorspróf,1,1,2
594,2011,Sálfræðideild,,32,81,113
595,2011,Sálfræðideild,Grunnnám,29,56,85
596,2011,Sálfræðideild,Viðbótarnám,0,0,0
597,2011,Sálfræðideild,Meistarapróf,3,25,28
598,2011,Sálfræðideild,Doktorspróf,0,0,0
599,2011,Tannlæknadeild,,2,8,10
600,2011,Tannlæknadeild,Grunnnám,2,8,10
601,2011,Tannlæknadeild,Viðbótarnám,0,0,0
602,2011,Tannlæknadeild,Meistarapróf,0,0,0
603,2011,Tannlæknadeild,Doktorspróf,0,0,0
604,2011,"Deild erlendra tungumála, bókmennta og málvísinda",,23,70,93
605,2011,"Deild erlendra tungumála, bókmennta og málvísinda",Grunnnám,23,64,87
606,2011,"Deild erlendra tungumála, bókmennta og málvísinda",Viðbótarnám,0,0,0
607,2011,"Deild erlendra tungumála, bókmennta og málvísinda",Meistarapróf,0,6,6
608,2011,"Deild erlendra tungumála, bókmennta og málvísinda",Doktorspróf,0,0,0
609,2011,Guðfræði- og trúarbragðafræðideild,,38,76,114
610,2011,Guðfræði- og trúarbragðafræðideild,Grunnnám,37,74,111
611,2011,Guðfræði- og trúarbragðafræðideild,Viðbótarnám,0,2,2
612,2011,Guðfræði- og trúarbragðafræðideild,Meistarapróf,1,0,1
613,2011,Guðfræði- og trúarbragðafræðideild,Doktorspróf,0,0,0
614,2011,Íslensku- og menningardeild,,36,132,168
615,2011,Íslensku- og menningardeild,Grunnnám,25,81,106
616,2011,Íslensku- og menningardeild,Viðbótarnám,0,1,1
617,2011,Íslensku- og menningardeild,Meistarapróf,9,49,58
618,2011,Íslensku- og menningardeild,Doktorspróf,2,1,3
619,2011,Sagnfræði- og heimspekideild,,40,53,75
620,2011,Sagnfræði- og heimspekideild,Grunnnám,26,27,35
621,2011,Sagnfræði- og heimspekideild,Viðbótarnám,0,0,0
622,2011,Sagnfræði- og heimspekideild,Meistarapróf,14,23,37
623,2011,Sagnfræði- og heimspekideild,Doktorspróf,0,3,3
624,2011,"Íþrótta-, tómstunda- og þroskaþjálfadeild",,38,79,117
625,2011,"Íþrótta-, tómstunda- og þroskaþjálfadeild",Grunnnám,37,74,111
626,2011,"Íþrótta-, tómstunda- og þroskaþjálfadeild",Viðbótarnám,0,0,0
627,2011,"Íþrótta-, tómstunda- og þroskaþjálfadeild",Meistarapróf,1,5,6
628,2011,"Íþrótta-, tómstunda- og þroskaþjálfadeild",Doktorspróf,0,0,0
629,2011,Kennaradeild,,86,387,473
630,2011,Kennaradeild,Grunnnám,55,288,343
631,2011,Kennaradeild,Viðbótarnám,27,77,104
632,2011,Kennaradeild,Meistarapróf,4,22,26
633,2011,Kennaradeild,Doktorspróf,0,0,0
634,2011,Uppeldis- og menntunarfræðideild,,7,86,93
635,2011,Uppeldis- og menntunarfræðideild,Grunnnám,1,20,21
636,2011,Uppeldis- og menntunarfræðideild,Viðbótarnám,2,18,20
637,2011,Uppeldis- og menntunarfræðideild,Meistarapróf,3,46,49
638,2011,Uppeldis- og menntunarfræðideild,Doktorspróf,1,2,3
639,2011,"Iðnaðarverkfræði-, vélaverkfræði- og tölvunarfræðideild",,92,42,134
640,2011,"Iðnaðarverkfræði-, vélaverkfræði- og tölvunarfræðideild",Grunnnám,59,17,76
641,2011,"Iðnaðarverkfræði-, vélaverkfræði- og tölvunarfræðideild",Viðbótarnám,0,0,0
642,2011,"Iðnaðarverkfræði-, vélaverkfræði- og tölvunarfræðideild",Meistarapróf,32,25,57
643,2011,"Iðnaðarverkfræði-, vélaverkfræði- og tölvunarfræðideild",Doktorspróf,1,0,1
644,2011,Jarðvísindadeild,,15,8,23
645,2011,Jarðvísindadeild,Grunnnám,4,6,10
646,2011,Jarðvísindadeild,Viðbótarnám,0,0,0
647,2011,Jarðvísindadeild,Meistarapróf,9,2,11
648,2011,Jarðvísindadeild,Doktorspróf,2,0,2
649,2011,Líf- og umhverfisvísindadeild,,33,51,84
650,2011,Líf- og umhverfisvísindadeild,Grunnnám,23,41,64
651,2011,Líf- og umhverfisvísindadeild,Viðbótarnám,0,0,0
652,2011,Líf- og umhverfisvísindadeild,Meistarapróf,6,8,14
653,2011,Líf- og umhverfisvísindadeild,Doktorspróf,4,2,6
654,2011,Umhverfis- og auðlindafræði,,2,9,11
655,2011,Umhverfis- og auðlindafræði,Grunnnám,0,0,0
656,2011,Umhverfis- og auðlindafræði,Viðbótarnám,0,0,0
657,2011,Umhverfis- og auðlindafræði,Meistarapróf,2,9,11
658,2011,Umhverfis- og auðlindafræði,Doktorspróf,0,0,0
659,2011,Rafmagns- og tölvuverkfræðideild,,10,6,16
660,2011,Rafmagns- og tölvuverkfræðideild,Grunnnám,7,5,12
661,2011,Rafmagns- og tölvuverkfræðideild,Viðbótarnám,0,0,0
662,2011,Rafmagns- og tölvuverkfræðideild,Meistarapróf,1,0,1
663,2011,Rafmagns- og tölvuverkfræðideild,Doktorspróf,2,1,3
664,2011,Raunvísindadeild,,28,19,47
665,2011,Raunvísindadeild,Grunnnám,18,9,27
666,2011,Raunvísindadeild,Viðbótarnám,0,0,0
667,2011,Raunvísindadeild,Meistarapróf,4,5,9
668,2011,Raunvísindadeild,Doktorspróf,6,5,11
669,2011,Umhverfis- og byggingaverkfræðideild,,45,14,59
670,2011,Umhverfis- og byggingaverkfræðideild,Grunnnám,33,11,44
671,2011,Umhverfis- og byggingaverkfræðideild,Viðbótarnám,0,0,0
672,2011,Umhverfis- og byggingaverkfræðideild,Meistarapróf,12,3,15
673,2011,Umhverfis- og byggingaverkfræðideild,Doktorspróf,0,0,0
674,2012,Félags- og mannvísindadeild,,45,187,232
675,2012,Félags- og mannvísindadeild,Grunnnám,30,96,126
676,2012,Félags- og mannvísindadeild,Viðbótarnám,9,38,47
677,2012,Félags- og mannvísindadeild,Meistarapróf,5,53,58
678,2012,Félags- og mannvísindadeild,Doktorspróf,1,0,1
679,2012,Félagsráðgjafardeild,,9,114,123
680,2012,Félagsráðgjafardeild,Grunnnám,6,76,82
681,2012,Félagsráðgjafardeild,Viðbótarnám,0,2,2
682,2012,Félagsráðgjafardeild,Meistarapróf,3,36,39
683,2012,Félagsráðgjafardeild,Doktorspróf,0,0,0
684,2012,Hagfræðideild,,35,31,66
685,2012,Hagfræðideild,Grunnnám,24,18,42
686,2012,Hagfræðideild,Viðbótarnám,11,13,24
687,2012,Hagfræðideild,Meistarapróf,0,0,0
688,2012,Hagfræðideild,Doktorspróf,0,0,0
689,2012,Lagadeild,,36,31,67
690,2012,Lagadeild,Grunnnám,24,18,42
691,2012,Lagadeild,Viðbótarnám,0,0,0
692,2012,Lagadeild,Meistarapróf,11,13,24
693,2012,Lagadeild,Doktorspróf,1,0,1
694,2012,Stjórnmálafræðideild,,44,106,150
695,2012,Stjórnmálafræðideild,Grunnnám,22,30,52
696,2012,Stjórnmálafræðideild,Viðbótarnám,9,48,57
697,2012,Stjórnmálafræðideild,Meistarapróf,13,27,40
698,2012,Stjórnmálafræðideild,Doktorspróf,0,1,1
699,2012,Viðskiptafræðideild,,110,174,284
700,2012,Viðskiptafræðideild,Grunnnám,35,59,94
701,2012,Viðskiptafræðideild,Viðbótarnám,0,0,0
702,2012,Viðskiptafræðideild,Meistarapróf,74,114,188
703,2012,Viðskiptafræðideild,Doktorspróf,1,1,2
704,2012,Hjúkrunarfræðideild,,2,97,99
705,2012,Hjúkrunarfræðideild,Grunnnám,1,52,53
706,2012,Hjúkrunarfræðideild,Viðbótarnám,1,31,32
707,2012,Hjúkrunarfræðideild,Meistarapróf,0,13,13
708,2012,Hjúkrunarfræðideild,Doktorspróf,0,1,1
709,2012,Lyfjafræðideild,,7,29,36
710,2012,Lyfjafræðideild,Grunnnám,3,13,16
711,2012,Lyfjafræðideild,Viðbótarnám,4,16,20
712,2012,Lyfjafræðideild,Meistarapróf,0,0,0
713,2012,Lyfjafræðideild,Doktorspróf,0,0,0
714,2012,Læknadeild,,57,102,159
715,2012,Læknadeild,Grunnnám,50,72,122
716,2012,Læknadeild,Viðbótarnám,1,12,13
717,2012,Læknadeild,Meistarapróf,3,17,20
718,2012,Læknadeild,Doktorspróf,3,1,4
719,2012,Lýðheilsuvísindi,,0,27,27
720,2012,Lýðheilsuvísindi,Grunnnám,0,0,0
721,2012,Lýðheilsuvísindi,Viðbótarnám,0,8,8
722,2012,Lýðheilsuvísindi,Meistarapróf,0,16,16
723,2012,Lýðheilsuvísindi,Doktorspróf,0,3,3
724,2012,Matvæla- og næringarfræðideild,,4,26,30
725,2012,Matvæla- og næringarfræðideild,Grunnnám,4,20,24
726,2012,Matvæla- og næringarfræðideild,Viðbótarnám,0,0,0
727,2012,Matvæla- og næringarfræðideild,Meistarapróf,0,5,5
728,2012,Matvæla- og næringarfræðideild,Doktorspróf,0,1,1
729,2012,Sálfræðideild,,28,84,112
730,2012,Sálfræðideild,Grunnnám,22,61,83
731,2012,Sálfræðideild,Viðbótarnám,0,0,0
732,2012,Sálfræðideild,Meistarapróf,6,23,29
733,2012,Sálfræðideild,Doktorspróf,0,0,0
734,2012,Tannlæknadeild,,2,16,18
735,2012,Tannlæknadeild,Grunnnám,2,14,16
736,2012,Tannlæknadeild,Viðbótarnám,0,2,2
737,2012,Tannlæknadeild,Meistarapróf,0,0,0
738,2012,Tannlæknadeild,Doktorspróf,0,0,0
739,2012,"Deild erlendra tungumála, bókmennta og málvísinda",,39,89,128
740,2012,"Deild erlendra tungumála, bókmennta og málvísinda",Grunnnám,36,79,115
741,2012,"Deild erlendra tungumála, bókmennta og málvísinda",Viðbótarnám,0,0,0
742,2012,"Deild erlendra tungumála, bókmennta og málvísinda",Meistarapróf,3,10,13
743,2012,"Deild erlendra tungumála, bókmennta og málvísinda",Doktorspróf,0,0,0
744,2012,Guðfræði- og trúarbragðafræðideild,,11,18,29
745,2012,Guðfræði- og trúarbragðafræðideild,Grunnnám,7,15,22
746,2012,Guðfræði- og trúarbragðafræðideild,Viðbótarnám,0,1,1
747,2012,Guðfræði- og trúarbragðafræðideild,Meistarapróf,4,1,5
748,2012,Guðfræði- og trúarbragðafræðideild,Doktorspróf,0,1,1
749,2012,Íslensku- og menningardeild,,56,110,166
750,2012,Íslensku- og menningardeild,Grunnnám,30,70,100
751,2012,Íslensku- og menningardeild,Viðbótarnám,0,3,3
752,2012,Íslensku- og menningardeild,Meistarapróf,25,37,62
753,2012,Íslensku- og menningardeild,Doktorspróf,1,0,1
754,2012,Sagnfræði- og heimspekideild,,48,53,101
755,2012,Sagnfræði- og heimspekideild,Grunnnám,37,24,61
756,2012,Sagnfræði- og heimspekideild,Viðbótarnám,1,2,3
757,2012,Sagnfræði- og heimspekideild,Meistarapróf,8,27,35
758,2012,Sagnfræði- og heimspekideild,Doktorspróf,2,0,2
759,2012,"Íþrótta-, tómstunda- og þroskaþjálfadeild",,20,77,97
760,2012,"Íþrótta-, tómstunda- og þroskaþjálfadeild",Grunnnám,18,73,91
761,2012,"Íþrótta-, tómstunda- og þroskaþjálfadeild",Viðbótarnám,0,0,0
762,2012,"Íþrótta-, tómstunda- og þroskaþjálfadeild",Meistarapróf,2,4,6
763,2012,"Íþrótta-, tómstunda- og þroskaþjálfadeild",Doktorspróf,0,0,0
764,2012,Kennaradeild,,42,200,242
765,2012,Kennaradeild,Grunnnám,29,144,173
766,2012,Kennaradeild,Viðbótarnám,8,32,40
767,2012,Kennaradeild,Meistarapróf,5,24,29
768,2012,Kennaradeild,Doktorspróf,0,0,0
769,2012,Uppeldis- og menntunarfræðideild,,10,94,104
770,2012,Uppeldis- og menntunarfræðideild,Grunnnám,3,31,34
771,2012,Uppeldis- og menntunarfræðideild,Viðbótarnám,1,17,18
772,2012,Uppeldis- og menntunarfræðideild,Meistarapróf,6,44,50
773,2012,Uppeldis- og menntunarfræðideild,Doktorspróf,0,2,2
774,2012,"Iðnaðarverkfræði-, vélaverkfræði- og tölvunarfræðideild",,105,39,144
775,2012,"Iðnaðarverkfræði-, vélaverkfræði- og tölvunarfræðideild",Grunnnám,80,33,113
776,2012,"Iðnaðarverkfræði-, vélaverkfræði- og tölvunarfræðideild",Viðbótarnám,0,0,0
777,2012,"Iðnaðarverkfræði-, vélaverkfræði- og tölvunarfræðideild",Meistarapróf,24,5,29
778,2012,"Iðnaðarverkfræði-, vélaverkfræði- og tölvunarfræðideild",Doktorspróf,1,1,2
779,2012,Jarðvísindadeild,,14,26,40
780,2012,Jarðvísindadeild,Grunnnám,9,18,27
781,2012,Jarðvísindadeild,Viðbótarnám,0,0,0
782,2012,Jarðvísindadeild,Meistarapróf,4,6,10
783,2012,Jarðvísindadeild,Doktorspróf,1,2,3
784,2012,Líf- og umhverfisvísindadeild,,42,70,112
785,2012,Líf- og umhverfisvísindadeild,Grunnnám,37,61,98
786,2012,Líf- og umhverfisvísindadeild,Viðbótarnám,1,1,2
787,2012,Líf- og umhverfisvísindadeild,Meistarapróf,4,6,10
788,2012,Líf- og umhverfisvísindadeild,Doktorspróf,0,2,2
789,2012,Umhverfis- og auðlindafræði,,5,15,20
790,2012,Umhverfis- og auðlindafræði,Grunnnám,0,0,0
791,2012,Umhverfis- og auðlindafræði,Viðbótarnám,0,0,0
792,2012,Umhverfis- og auðlindafræði,Meistarapróf,5,15,20
793,2012,Umhverfis- og auðlindafræði,Doktorspróf,0,0,0
794,2012,Rafmagns- og tölvuverkfræðideild,,25,3,28
795,2012,Rafmagns- og tölvuverkfræðideild,Grunnnám,23,3,26
796,2012,Rafmagns- og tölvuverkfræðideild,Viðbótarnám,0,0,0
797,2012,Rafmagns- og tölvuverkfræðideild,Meistarapróf,2,0,2
798,2012,Rafmagns- og tölvuverkfræðideild,Doktorspróf,0,0,0
799,2012,Raunvísindadeild,,44,21,65
800,2012,Raunvísindadeild,Grunnnám,29,18,47
801,2012,Raunvísindadeild,Viðbótarnám,0,1,1
802,2012,Raunvísindadeild,Meistarapróf,9,2,11
803,2012,Raunvísindadeild,Doktorspróf,6,0,6
804,2012,Umhverfis- og byggingaverkfræðideild,,33,20,53
805,2012,Umhverfis- og byggingaverkfræðideild,Grunnnám,25,14,39
806,2012,Umhverfis- og byggingaverkfræðideild,Viðbótarnám,0,0,0
807,2012,Umhverfis- og byggingaverkfræðideild,Meistarapróf,8,5,13
808,2012,Umhverfis- og byggingaverkfræðideild,Doktorspróf,0,1,1
809,2013,Félags- og mannvísindadeild,,29,182,211
810,2013,Félags- og mannvísindadeild,Grunnnám,16,94,110
811,2013,Félags- og mannvísindadeild,Viðbótarnám,7,32,39
812,2013,Félags- og mannvísindadeild,Meistarapróf,6,53,59
813,2013,Félags- og mannvísindadeild,Doktorspróf,0,3,3
814,2013,Félagsráðgjafardeild,,10,98,108
815,2013,Félagsráðgjafardeild,Grunnnám,8,72,80
816,2013,Félagsráðgjafardeild,Viðbótarnám,0,1,1
817,2013,Félagsráðgjafardeild,Meistarapróf,2,25,27
818,2013,Félagsráðgjafardeild,Doktorspróf,0,0,0
819,2013,Hagfræðideild,,28,22,50
820,2013,Hagfræðideild,Grunnnám,20,14,34
821,2013,Hagfræðideild,Viðbótarnám,0,0,0
822,2013,Hagfræðideild,Meistarapróf,7,8,15
823,2013,Hagfræðideild,Doktorspróf,1,0,1
824,2013,Lagadeild,,82,93,175
825,2013,Lagadeild,Grunnnám,42,53,95
826,2013,Lagadeild,Viðbótarnám,0,0,0
827,2013,Lagadeild,Meistarapróf,40,40,80
828,2013,Lagadeild,Doktorspróf,0,0,0
829,2013,Stjórnmálafræðideild,,45,96,141
830,2013,Stjórnmálafræðideild,Grunnnám,19,22,41
831,2013,Stjórnmálafræðideild,Viðbótarnám,15,42,57
832,2013,Stjórnmálafræðideild,Meistarapróf,11,31,42
833,2013,Stjórnmálafræðideild,Doktorspróf,0,1,1
834,2013,Viðskiptafræðideild,,109,164,273
835,2013,Viðskiptafræðideild,Grunnnám,50,77,127
836,2013,Viðskiptafræðideild,Viðbótarnám,0,0,0
837,2013,Viðskiptafræðideild,Meistarapróf,59,87,146
838,2013,Viðskiptafræðideild,Doktorspróf,0,0,0
839,2013,Hjúkrunarfræðideild,,1,102,103
840,2013,Hjúkrunarfræðideild,Grunnnám,1,88,89
841,2013,Hjúkrunarfræðideild,Viðbótarnám,0,0,0
842,2013,Hjúkrunarfræðideild,Meistarapróf,0,13,13
843,2013,Hjúkrunarfræðideild,Doktorspróf,0,1,1
844,2013,Lyfjafræðideild,,4,24,28
845,2013,Lyfjafræðideild,Grunnnám,1,11,12
846,2013,Lyfjafræðideild,Viðbótarnám,0,0,0
847,2013,Lyfjafræðideild,Meistarapróf,3,12,15
848,2013,Lyfjafræðideild,Doktorspróf,0,1,1
849,2013,Læknadeild,,59,112,171
850,2013,Læknadeild,Grunnnám,48,75,123
851,2013,Læknadeild,Viðbótarnám,0,14,14
852,2013,Læknadeild,Meistarapróf,5,18,23
853,2013,Læknadeild,Doktorspróf,6,5,11
854,2013,Lýðheilsuvísindi,,2,22,24
855,2013,Lýðheilsuvísindi,Grunnnám,1,9,10
856,2013,Lýðheilsuvísindi,Viðbótarnám,0,0,0
857,2013,Lýðheilsuvísindi,Meistarapróf,0,13,13
858,2013,Lýðheilsuvísindi,Doktorspróf,1,0,1
859,2013,Matvæla- og næringarfræðideild,,2,19,21
860,2013,Matvæla- og næringarfræðideild,Grunnnám,1,9,10
861,2013,Matvæla- og næringarfræðideild,Viðbótarnám,0,0,0
862,2013,Matvæla- og næringarfræðideild,Meistarapróf,0,7,7
863,2013,Matvæla- og næringarfræðideild,Doktorspróf,1,3,4
864,2013,Sálfræðideild,,29,122,151
865,2013,Sálfræðideild,Grunnnám,23,96,119
866,2013,Sálfræðideild,Viðbótarnám,0,0,0
867,2013,Sálfræðideild,Meistarapróf,5,26,31
868,2013,Sálfræðideild,Doktorspróf,1,0,1
869,2013,Tannlæknadeild,,3,10,13
870,2013,Tannlæknadeild,Grunnnám,3,10,13
871,2013,Tannlæknadeild,Viðbótarnám,0,0,0
872,2013,Tannlæknadeild,Meistarapróf,0,0,0
873,2013,Tannlæknadeild,Doktorspróf,0,0,0
874,2013,"Deild erlendra tungumála, bókmennta og málvísinda",,24,62,86
875,2013,"Deild erlendra tungumála, bókmennta og málvísinda",Grunnnám,23,53,76
876,2013,"Deild erlendra tungumála, bókmennta og málvísinda",Viðbótarnám,0,0,0
877,2013,"Deild erlendra tungumála, bókmennta og málvísinda",Meistarapróf,1,8,9
878,2013,"Deild erlendra tungumála, bókmennta og málvísinda",Doktorspróf,0,1,1
879,2013,Guðfræði- og trúarbragðafræðideild,,9,15,24
880,2013,Guðfræði- og trúarbragðafræðideild,Grunnnám,6,8,14
881,2013,Guðfræði- og trúarbragðafræðideild,Viðbótarnám,0,2,2
882,2013,Guðfræði- og trúarbragðafræðideild,Meistarapróf,3,5,8
883,2013,Guðfræði- og trúarbragðafræðideild,Doktorspróf,0,0,0
884,2013,Íslensku- og menningardeild,,42,126,168
885,2013,Íslensku- og menningardeild,Grunnnám,31,93,124
886,2013,Íslensku- og menningardeild,Viðbótarnám,0,3,3
887,2013,Íslensku- og menningardeild,Meistarapróf,10,30,40
888,2013,Íslensku- og menningardeild,Doktorspróf,1,0,1
889,2013,Sagnfræði- og heimspekideild,,51,51,102
890,2013,Sagnfræði- og heimspekideild,Grunnnám,43,23,66
891,2013,Sagnfræði- og heimspekideild,Viðbótarnám,0,2,2
892,2013,Sagnfræði- og heimspekideild,Meistarapróf,6,25,31
893,2013,Sagnfræði- og heimspekideild,Doktorspróf,2,1,3
894,2013,"Íþrótta-, tómstunda- og þroskaþjálfadeild",,32,93,125
895,2013,"Íþrótta-, tómstunda- og þroskaþjálfadeild",Grunnnám,30,82,112
896,2013,"Íþrótta-, tómstunda- og þroskaþjálfadeild",Viðbótarnám,0,3,3
897,2013,"Íþrótta-, tómstunda- og þroskaþjálfadeild",Meistarapróf,2,8,10
898,2013,"Íþrótta-, tómstunda- og þroskaþjálfadeild",Doktorspróf,0,0,0
899,2013,Kennaradeild,,51,200,251
900,2013,Kennaradeild,Grunnnám,36,130,166
901,2013,Kennaradeild,Viðbótarnám,12,38,50
902,2013,Kennaradeild,Meistarapróf,3,32,35
903,2013,Kennaradeild,Doktorspróf,0,0,0
904,2013,Uppeldis- og menntunarfræðideild,,12,78,90
905,2013,Uppeldis- og menntunarfræðideild,Grunnnám,4,26,30
906,2013,Uppeldis- og menntunarfræðideild,Viðbótarnám,1,13,14
907,2013,Uppeldis- og menntunarfræðideild,Meistarapróf,4,38,42
908,2013,Uppeldis- og menntunarfræðideild,Doktorspróf,3,1,4
909,2013,"Iðnaðarverkfræði-, vélaverkfræði- og tölvunarfræðideild",,116,48,164
910,2013,"Iðnaðarverkfræði-, vélaverkfræði- og tölvunarfræðideild",Grunnnám,95,39,134
911,2013,"Iðnaðarverkfræði-, vélaverkfræði- og tölvunarfræðideild",Viðbótarnám,0,0,0
912,2013,"Iðnaðarverkfræði-, vélaverkfræði- og tölvunarfræðideild",Meistarapróf,20,9,29
913,2013,"Iðnaðarverkfræði-, vélaverkfræði- og tölvunarfræðideild",Doktorspróf,1,0,1
914,2013,Jarðvísindadeild,,20,17,37
915,2013,Jarðvísindadeild,Grunnnám,15,10,25
916,2013,Jarðvísindadeild,Viðbótarnám,0,0,0
917,2013,Jarðvísindadeild,Meistarapróf,3,5,8
918,2013,Jarðvísindadeild,Doktorspróf,2,2,4
919,2013,Líf- og umhverfisvísindadeild,,31,63,94
920,2013,Líf- og umhverfisvísindadeild,Grunnnám,26,51,77
921,2013,Líf- og umhverfisvísindadeild,Viðbótarnám,0,1,1
922,2013,Líf- og umhverfisvísindadeild,Meistarapróf,3,7,10
923,2013,Líf- og umhverfisvísindadeild,Doktorspróf,2,4,6
924,2013,Umhverfis- og auðlindafræði,,3,4,7
925,2013,Umhverfis- og auðlindafræði,Grunnnám,0,0,0
926,2013,Umhverfis- og auðlindafræði,Viðbótarnám,0,0,0
927,2013,Umhverfis- og auðlindafræði,Meistarapróf,3,3,6
928,2013,Umhverfis- og auðlindafræði,Doktorspróf,0,1,1
929,2013,Rafmagns- og tölvuverkfræðideild,,11,1,12
930,2013,Rafmagns- og tölvuverkfræðideild,Grunnnám,9,1,10
931,2013,Rafmagns- og tölvuverkfræðideild,Viðbótarnám,0,0,0
932,2013,Rafmagns- og tölvuverkfræðideild,Meistarapróf,0,0,0
933,2013,Rafmagns- og tölvuverkfræðideild,Doktorspróf,2,0,2
934,2013,Raunvísindadeild,,31,24,55
935,2013,Raunvísindadeild,Grunnnám,22,21,43
936,2013,Raunvísindadeild,Viðbótarnám,0,0,0
937,2013,Raunvísindadeild,Meistarapróf,3,2,5
938,2013,Raunvísindadeild,Doktorspróf,6,1,7
939,2013,Umhverfis- og byggingaverkfræðideild,,18,15,33
940,2013,Umhverfis- og byggingaverkfræðideild,Grunnnám,14,13,27
941,2013,Umhverfis- og byggingaverkfræðideild,Viðbótarnám,0,0,0
942,2013,Umhverfis- og byggingaverkfræðideild,Meistarapróf,4,2,6
943,2013,Umhverfis- og byggingaverkfræðideild,Doktorspróf,0,0,0
944,2014,Félags- og mannvísindadeild,,49,190,239
945,2014,Félags- og mannvísindadeild,Grunnnám,26,99,125
946,2014,Félags- og mannvísindadeild,Viðbótarnám,8,38,46
947,2014,Félags- og mannvísindadeild,Meistarapróf,13,51,64
948,2014,Félags- og mannvísindadeild,Doktorspróf,2,2,4
949,2014,Félagsráðgjafardeild,,5,147,152
950,2014,Félagsráðgjafardeild,Grunnnám,2,98,100
951,2014,Félagsráðgjafardeild,Viðbótarnám,0,3,3
952,2014,Félagsráðgjafardeild,Meistarapróf,3,44,47
953,2014,Félagsráðgjafardeild,Doktorspróf,0,2,2
954,2014,Hagfræðideild,,31,14,45
955,2014,Hagfræðideild,Grunnnám,17,8,25
956,2014,Hagfræðideild,Viðbótarnám,1,1,2
957,2014,Hagfræðideild,Meistarapróf,13,5,18
958,2014,Hagfræðideild,Doktorspróf,0,0,0
959,2014,Lagadeild,,76,81,157
960,2014,Lagadeild,Grunnnám,40,42,82
961,2014,Lagadeild,Viðbótarnám,36,39,75
962,2014,Lagadeild,Meistarapróf,0,0,0
963,2014,Lagadeild,Doktorspróf,0,0,0
964,2014,Stjórnmálafræðideild,,69,73,142
965,2014,Stjórnmálafræðideild,Grunnnám,23,17,40
966,2014,Stjórnmálafræðideild,Viðbótarnám,29,54,83
967,2014,Stjórnmálafræðideild,Meistarapróf,16,2,18
968,2014,Stjórnmálafræðideild,Doktorspróf,1,0,1
969,2014,Viðskiptafræðideild,,118,133,251
970,2014,Viðskiptafræðideild,Grunnnám,50,52,102
971,2014,Viðskiptafræðideild,Viðbótarnám,0,0,0
972,2014,Viðskiptafræðideild,Meistarapróf,67,81,148
973,2014,Viðskiptafræðideild,Doktorspróf,1,0,1
974,2014,Hjúkrunarfræðideild,,2,116,118
975,2014,Hjúkrunarfræðideild,Grunnnám,2,90,92
976,2014,Hjúkrunarfræðideild,Viðbótarnám,0,10,10
977,2014,Hjúkrunarfræðideild,Meistarapróf,0,13,13
978,2014,Hjúkrunarfræðideild,Doktorspróf,0,3,3
979,2014,Lyfjafræðideild,,9,32,41
980,2014,Lyfjafræðideild,Grunnnám,3,16,19
981,2014,Lyfjafræðideild,Viðbótarnám,4,13,17
982,2014,Lyfjafræðideild,Meistarapróf,0,0,0
983,2014,Lyfjafræðideild,Doktorspróf,2,3,5
984,2014,Læknadeild,,62,115,177
985,2014,Læknadeild,Grunnnám,32,56,88
986,2014,Læknadeild,Viðbótarnám,23,38,61
987,2014,Læknadeild,Meistarapróf,3,15,18
988,2014,Læknadeild,Doktorspróf,4,6,10
989,2014,Lýðheilsuvísindi,,0,0,0
990,2014,Lýðheilsuvísindi,Grunnnám,0,0,0
991,2014,Lýðheilsuvísindi,Viðbótarnám,0,0,0
992,2014,Lýðheilsuvísindi,Meistarapróf,0,0,0
993,2014,Lýðheilsuvísindi,Doktorspróf,0,0,0
994,2014,Matvæla- og næringarfræðideild,,2,26,28
995,2014,Matvæla- og næringarfræðideild,Grunnnám,2,11,13
996,2014,Matvæla- og næringarfræðideild,Viðbótarnám,0,0,0
997,2014,Matvæla- og næringarfræðideild,Meistarapróf,0,11,11
998,2014,Matvæla- og næringarfræðideild,Doktorspróf,0,4,4
999,2014,Sálfræðideild,,49,116,165
1000,2014,Sálfræðideild,Grunnnám,44,87,131
1001,2014,Sálfræðideild,Viðbótarnám,0,0,0
1002,2014,Sálfræðideild,Meistarapróf,4,29,33
1003,2014,Sálfræðideild,Doktorspróf,1,0,1
1004,2014,Tannlæknadeild,,2,0,2
1005,2014,Tannlæknadeild,Grunnnám,0,0,0
1006,2014,Tannlæknadeild,Viðbótarnám,0,0,0
1007,2014,Tannlæknadeild,Meistarapróf,0,0,0
1008,2014,Tannlæknadeild,Doktorspróf,2,0,2
1009,2014,"Deild erlendra tungumála, bókmennta og málvísinda",,25,92,117
1010,2014,"Deild erlendra tungumála, bókmennta og málvísinda",Grunnnám,22,72,94
1011,2014,"Deild erlendra tungumála, bókmennta og málvísinda",Viðbótarnám,0,0,0
1012,2014,"Deild erlendra tungumála, bókmennta og málvísinda",Meistarapróf,3,19,22
1013,2014,"Deild erlendra tungumála, bókmennta og málvísinda",Doktorspróf,0,1,1
1014,2014,Guðfræði- og trúarbragðafræðideild,,11,15,26
1015,2014,Guðfræði- og trúarbragðafræðideild,Grunnnám,5,9,14
1016,2014,Guðfræði- og trúarbragðafræðideild,Viðbótarnám,0,1,1
1017,2014,Guðfræði- og trúarbragðafræðideild,Meistarapróf,5,4,9
1018,2014,Guðfræði- og trúarbragðafræðideild,Doktorspróf,1,1,2
1019,2014,Íslensku- og menningardeild,,55,151,206
1020,2014,Íslensku- og menningardeild,Grunnnám,31,85,116
1021,2014,Íslensku- og menningardeild,Viðbótarnám,1,3,4
1022,2014,Íslensku- og menningardeild,Meistarapróf,23,60,83
1023,2014,Íslensku- og menningardeild,Doktorspróf,0,3,3
1024,2014,Sagnfræði- og heimspekideild,,60,53,89
1025,2014,Sagnfræði- og heimspekideild,Grunnnám,39,20,35
1026,2014,Sagnfræði- og heimspekideild,Viðbótarnám,1,3,4
1027,2014,Sagnfræði- og heimspekideild,Meistarapróf,18,29,47
1028,2014,Sagnfræði- og heimspekideild,Doktorspróf,2,1,3
1029,2014,"Íþrótta-, tómstunda- og þroskaþjálfadeild",,25,85,110
1030,2014,"Íþrótta-, tómstunda- og þroskaþjálfadeild",Grunnnám,23,75,98
1031,2014,"Íþrótta-, tómstunda- og þroskaþjálfadeild",Viðbótarnám,0,8,8
1032,2014,"Íþrótta-, tómstunda- og þroskaþjálfadeild",Meistarapróf,2,2,4
1033,2014,"Íþrótta-, tómstunda- og þroskaþjálfadeild",Doktorspróf,0,0,0
1034,2014,Kennaradeild,,33,180,213
1035,2014,Kennaradeild,Grunnnám,24,101,125
1036,2014,Kennaradeild,Viðbótarnám,4,15,19
1037,2014,Kennaradeild,Meistarapróf,4,63,67
1038,2014,Kennaradeild,Doktorspróf,1,1,2
1039,2014,Uppeldis- og menntunarfræðideild,,11,97,108
1040,2014,Uppeldis- og menntunarfræðideild,Grunnnám,0,37,37
1041,2014,Uppeldis- og menntunarfræðideild,Viðbótarnám,3,20,23
1042,2014,Uppeldis- og menntunarfræðideild,Meistarapróf,6,35,41
1043,2014,Uppeldis- og menntunarfræðideild,Doktorspróf,2,5,7
1044,2014,"Iðnaðarverkfræði-, vélaverkfræði- og tölvunarfræðideild",,111,39,150
1045,2014,"Iðnaðarverkfræði-, vélaverkfræði- og tölvunarfræðideild",Grunnnám,93,33,126
1046,2014,"Iðnaðarverkfræði-, vélaverkfræði- og tölvunarfræðideild",Viðbótarnám,0,0,0
1047,2014,"Iðnaðarverkfræði-, vélaverkfræði- og tölvunarfræðideild",Meistarapróf,18,6,24
1048,2014,"Iðnaðarverkfræði-, vélaverkfræði- og tölvunarfræðideild",Doktorspróf,0,0,0
1049,2014,Jarðvísindadeild,,26,17,43
1050,2014,Jarðvísindadeild,Grunnnám,19,8,27
1051,2014,Jarðvísindadeild,Viðbótarnám,7,9,16
1052,2014,Jarðvísindadeild,Meistarapróf,0,0,0
1053,2014,Jarðvísindadeild,Doktorspróf,0,0,0
1054,2014,Líf- og umhverfisvísindadeild,,33,57,90
1055,2014,Líf- og umhverfisvísindadeild,Grunnnám,26,44,70
1056,2014,Líf- og umhverfisvísindadeild,Viðbótarnám,7,13,20
1057,2014,Líf- og umhverfisvísindadeild,Meistarapróf,0,0,0
1058,2014,Líf- og umhverfisvísindadeild,Doktorspróf,0,0,0
1059,2014,Umhverfis- og auðlindafræði,,20,76,96
1060,2014,Umhverfis- og auðlindafræði,Grunnnám,0,0,0
1061,2014,Umhverfis- og auðlindafræði,Viðbótarnám,4,24,28
1062,2014,Umhverfis- og auðlindafræði,Meistarapróf,15,50,65
1063,2014,Umhverfis- og auðlindafræði,Doktorspróf,1,2,3
1064,2014,Rafmagns- og tölvuverkfræðideild,,27,3,30
1065,2014,Rafmagns- og tölvuverkfræðideild,Grunnnám,27,3,30
1066,2014,Rafmagns- og tölvuverkfræðideild,Viðbótarnám,0,0,0
1067,2014,Rafmagns- og tölvuverkfræðideild,Meistarapróf,0,0,0
1068,2014,Rafmagns- og tölvuverkfræðideild,Doktorspróf,0,0,0
1069,2014,Raunvísindadeild,,37,28,65
1070,2014,Raunvísindadeild,Grunnnám,31,26,57
1071,2014,Raunvísindadeild,Viðbótarnám,0,0,0
1072,2014,Raunvísindadeild,Meistarapróf,6,2,8
1073,2014,Raunvísindadeild,Doktorspróf,0,0,0
1074,2014,Umhverfis- og byggingaverkfræðideild,,21,12,33
1075,2014,Umhverfis- og byggingaverkfræðideild,Grunnnám,15,5,20
1076,2014,Umhverfis- og byggingaverkfræðideild,Viðbótarnám,0,0,0
1077,2014,Umhverfis- og byggingaverkfræðideild,Meistarapróf,6,7,13
1078,2014,Umhverfis- og byggingaverkfræðideild,Doktorspróf,0,0,0
1079,2015,Félags- og mannvísindadeild,,35,187,222
1080,2015,Félags- og mannvísindadeild,Grunnnám,27,83,110
1081,2015,Félags- og mannvísindadeild,Viðbótarnám,5,46,51
1082,2015,Félags- og mannvísindadeild,Meistarapróf,3,57,60
1083,2015,Félags- og mannvísindadeild,Doktorspróf,0,1,1
1084,2015,Félagsráðgjafardeild,,12,97,109
1085,2015,Félagsráðgjafardeild,Grunnnám,7,61,68
1086,2015,Félagsráðgjafardeild,Viðbótarnám,0,0,0
1087,2015,Félagsráðgjafardeild,Meistarapróf,5,36,41
1088,2015,Félagsráðgjafardeild,Doktorspróf,0,0,0
1089,2015,Hagfræðideild,,27,15,42
1090,2015,Hagfræðideild,Grunnnám,20,13,33
1091,2015,Hagfræðideild,Viðbótarnám,0,0,0
1092,2015,Hagfræðideild,Meistarapróf,6,2,8
1093,2015,Hagfræðideild,Doktorspróf,1,0,1
1094,2015,Lagadeild,,73,112,185
1095,2015,Lagadeild,Grunnnám,39,54,93
1096,2015,Lagadeild,Viðbótarnám,0,0,0
1097,2015,Lagadeild,Meistarapróf,34,58,92
1098,2015,Lagadeild,Doktorspróf,0,0,0
1099,2015,Stjórnmálafræðideild,,56,112,168
1100,2015,Stjórnmálafræðideild,Grunnnám,23,15,38
1101,2015,Stjórnmálafræðideild,Viðbótarnám,21,69,90
1102,2015,Stjórnmálafræðideild,Meistarapróf,12,27,39
1103,2015,Stjórnmálafræðideild,Doktorspróf,0,1,1
1104,2015,Viðskiptafræðideild,,110,165,275
1105,2015,Viðskiptafræðideild,Grunnnám,53,58,111
1106,2015,Viðskiptafræðideild,Viðbótarnám,0,0,0
1107,2015,Viðskiptafræðideild,Meistarapróf,57,107,164
1108,2015,Viðskiptafræðideild,Doktorspróf,0,0,0
1109,2015,Hjúkrunarfræðideild,,2,126,128
1110,2015,Hjúkrunarfræðideild,Grunnnám,0,72,72
1111,2015,Hjúkrunarfræðideild,Viðbótarnám,2,43,45
1112,2015,Hjúkrunarfræðideild,Meistarapróf,0,10,10
1113,2015,Hjúkrunarfræðideild,Doktorspróf,0,1,1
1114,2015,Lyfjafræðideild,,6,36,42
1115,2015,Lyfjafræðideild,Grunnnám,6,23,29
1116,2015,Lyfjafræðideild,Viðbótarnám,0,0,0
1117,2015,Lyfjafræðideild,Meistarapróf,0,12,12
1118,2015,Lyfjafræðideild,Doktorspróf,0,1,1
1119,2015,Læknadeild,,54,117,171
1120,2015,Læknadeild,Grunnnám,28,55,83
1121,2015,Læknadeild,Viðbótarnám,18,37,55
1122,2015,Læknadeild,Meistarapróf,5,21,26
1123,2015,Læknadeild,Doktorspróf,3,4,7
1124,2015,Lýðheilsuvísindi,,2,35,37
1125,2015,Lýðheilsuvísindi,Grunnnám,0,0,0
1126,2015,Lýðheilsuvísindi,Viðbótarnám,1,22,23
1127,2015,Lýðheilsuvísindi,Meistarapróf,0,12,12
1128,2015,Lýðheilsuvísindi,Doktorspróf,1,1,2
1129,2015,Matvæla- og næringarfræðideild,,8,29,37
1130,2015,Matvæla- og næringarfræðideild,Grunnnám,6,16,22
1131,2015,Matvæla- og næringarfræðideild,Viðbótarnám,0,0,0
1132,2015,Matvæla- og næringarfræðideild,Meistarapróf,1,13,14
1133,2015,Matvæla- og næringarfræðideild,Doktorspróf,1,0,1
1134,2015,Sálfræðideild,,22,88,110
1135,2015,Sálfræðideild,Grunnnám,17,70,87
1136,2015,Sálfræðideild,Viðbótarnám,0,0,0
1137,2015,Sálfræðideild,Meistarapróf,5,18,23
1138,2015,Sálfræðideild,Doktorspróf,0,0,0
1139,2015,Tannlæknadeild,,2,10,12
1140,2015,Tannlæknadeild,Grunnnám,2,10,12
1141,2015,Tannlæknadeild,Viðbótarnám,0,0,0
1142,2015,Tannlæknadeild,Meistarapróf,0,0,0
1143,2015,Tannlæknadeild,Doktorspróf,0,0,0
1144,2015,"Deild erlendra tungumála, bókmennta og málvísinda",,38,93,131
1145,2015,"Deild erlendra tungumála, bókmennta og málvísinda",Grunnnám,22,72,94
1146,2015,"Deild erlendra tungumála, bókmennta og málvísinda",Viðbótarnám,5,5,10
1147,2015,"Deild erlendra tungumála, bókmennta og málvísinda",Meistarapróf,11,16,27
1148,2015,"Deild erlendra tungumála, bókmennta og málvísinda",Doktorspróf,0,0,0
1149,2015,Guðfræði- og trúarbragðafræðideild,,5,23,28
1150,2015,Guðfræði- og trúarbragðafræðideild,Grunnnám,3,9,12
1151,2015,Guðfræði- og trúarbragðafræðideild,Viðbótarnám,0,7,7
1152,2015,Guðfræði- og trúarbragðafræðideild,Meistarapróf,2,7,9
1153,2015,Guðfræði- og trúarbragðafræðideild,Doktorspróf,0,0,0
1154,2015,Íslensku- og menningardeild,,60,160,220
1155,2015,Íslensku- og menningardeild,Grunnnám,34,100,134
1156,2015,Íslensku- og menningardeild,Viðbótarnám,1,5,6
1157,2015,Íslensku- og menningardeild,Meistarapróf,23,51,74
1158,2015,Íslensku- og menningardeild,Doktorspróf,2,4,6
1159,2015,Sagnfræði- og heimspekideild,,47,47,89
1160,2015,Sagnfræði- og heimspekideild,Grunnnám,25,15,35
1161,2015,Sagnfræði- og heimspekideild,Viðbótarnám,1,2,3
1162,2015,Sagnfræði- og heimspekideild,Meistarapróf,17,29,46
1163,2015,Sagnfræði- og heimspekideild,Doktorspróf,4,1,5
1164,2015,"Íþrótta-, tómstunda- og þroskaþjálfadeild",,36,84,120
1165,2015,"Íþrótta-, tómstunda- og þroskaþjálfadeild",Grunnnám,30,69,99
1166,2015,"Íþrótta-, tómstunda- og þroskaþjálfadeild",Viðbótarnám,0,3,3
1167,2015,"Íþrótta-, tómstunda- og þroskaþjálfadeild",Meistarapróf,6,12,18
1168,2015,"Íþrótta-, tómstunda- og þroskaþjálfadeild",Doktorspróf,0,0,0
1169,2015,Kennaradeild,,47,215,262
1170,2015,Kennaradeild,Grunnnám,23,104,127
1171,2015,Kennaradeild,Viðbótarnám,12,30,42
1172,2015,Kennaradeild,Meistarapróf,12,81,93
1173,2015,Kennaradeild,Doktorspróf,0,0,0
1174,2015,Uppeldis- og menntunarfræðideild,,135,129,264
1175,2015,Uppeldis- og menntunarfræðideild,Grunnnám,128,45,173
1176,2015,Uppeldis- og menntunarfræðideild,Viðbótarnám,1,22,23
1177,2015,Uppeldis- og menntunarfræðideild,Meistarapróf,6,53,59
1178,2015,Uppeldis- og menntunarfræðideild,Doktorspróf,0,9,9
1179,2015,"Iðnaðarverkfræði-, vélaverkfræði- og tölvunarfræðideild",,147,51,198
1180,2015,"Iðnaðarverkfræði-, vélaverkfræði- og tölvunarfræðideild",Grunnnám,128,45,173
1181,2015,"Iðnaðarverkfræði-, vélaverkfræði- og tölvunarfræðideild",Viðbótarnám,0,0,0
1182,2015,"Iðnaðarverkfræði-, vélaverkfræði- og tölvunarfræðideild",Meistarapróf,18,5,23
1183,2015,"Iðnaðarverkfræði-, vélaverkfræði- og tölvunarfræðideild",Doktorspróf,1,1,2
1184,2015,Jarðvísindadeild,,22,20,42
1185,2015,Jarðvísindadeild,Grunnnám,13,13,26
1186,2015,Jarðvísindadeild,Viðbótarnám,6,7,13
1187,2015,Jarðvísindadeild,Meistarapróf,0,0,0
1188,2015,Jarðvísindadeild,Doktorspróf,3,0,3
1189,2015,Líf- og umhverfisvísindadeild,,42,72,114
1190,2015,Líf- og umhverfisvísindadeild,Grunnnám,33,60,93
1191,2015,Líf- og umhverfisvísindadeild,Viðbótarnám,0,0,0
1192,2015,Líf- og umhverfisvísindadeild,Meistarapróf,4,7,11
1193,2015,Líf- og umhverfisvísindadeild,Doktorspróf,5,5,10
1194,2015,Umhverfis- og auðlindafræði,,4,11,15
1195,2015,Umhverfis- og auðlindafræði,Grunnnám,0,0,0
1196,2015,Umhverfis- og auðlindafræði,Viðbótarnám,0,0,0
1197,2015,Umhverfis- og auðlindafræði,Meistarapróf,3,10,13
1198,2015,Umhverfis- og auðlindafræði,Doktorspróf,1,1,2
1199,2015,Rafmagns- og tölvuverkfræðideild,,39,0,39
1200,2015,Rafmagns- og tölvuverkfræðideild,Grunnnám,35,0,35
1201,2015,Rafmagns- og tölvuverkfræðideild,Viðbótarnám,0,0,0
1202,2015,Rafmagns- og tölvuverkfræðideild,Meistarapróf,1,0,1
1203,2015,Rafmagns- og tölvuverkfræðideild,Doktorspróf,3,0,3
1204,2015,Raunvísindadeild,,45,27,72
1205,2015,Raunvísindadeild,Grunnnám,34,20,54
1206,2015,Raunvísindadeild,Viðbótarnám,0,0,0
1207,2015,Raunvísindadeild,Meistarapróf,5,3,8
1208,2015,Raunvísindadeild,Doktorspróf,6,4,10
1209,2015,Umhverfis- og byggingaverkfræðideild,,24,16,40
1210,2015,Umhverfis- og byggingaverkfræðideild,Grunnnám,11,11,22
1211,2015,Umhverfis- og byggingaverkfræðideild,Viðbótarnám,0,0,0
1212,2015,Umhverfis- og byggingaverkfræðideild,Meistarapróf,13,4,17
1213,2015,Umhverfis- og byggingaverkfræðideild,Doktorspróf,0,1,1
1214,2016,Félags- og mannvísindadeild,,101,199,300
1215,2016,Félags- og mannvísindadeild,Grunnnám,27,84,111
1216,2016,Félags- og mannvísindadeild,Viðbótarnám,3,39,42
1217,2016,Félags- og mannvísindadeild,Meistarapróf,71,76,147
1218,2016,Félags- og mannvísindadeild,Doktorspróf,0,0,0
1219,2016,Félagsráðgjafardeild,,4,115,119
1220,2016,Félagsráðgjafardeild,Grunnnám,4,54,58
1221,2016,Félagsráðgjafardeild,Viðbótarnám,0,17,17
1222,2016,Félagsráðgjafardeild,Meistarapróf,0,44,44
1223,2016,Félagsráðgjafardeild,Doktorspróf,0,0,0
1224,2016,Hagfræðideild,,27,19,46
1225,2016,Hagfræðideild,Grunnnám,11,11,22
1226,2016,Hagfræðideild,Viðbótarnám,2,3,5
1227,2016,Hagfræðideild,Meistarapróf,14,4,18
1228,2016,Hagfræðideild,Doktorspróf,0,1,1
1229,2016,Lagadeild,,71,94,165
1230,2016,Lagadeild,Grunnnám,35,51,86
1231,2016,Lagadeild,Viðbótarnám,0,0,0
1232,2016,Lagadeild,Meistarapróf,36,42,78
1233,2016,Lagadeild,Doktorspróf,0,1,1
1234,2016,Stjórnmálafræðideild,,52,110,162
1235,2016,Stjórnmálafræðideild,Grunnnám,21,13,34
1236,2016,Stjórnmálafræðideild,Viðbótarnám,19,74,93
1237,2016,Stjórnmálafræðideild,Meistarapróf,12,22,34
1238,2016,Stjórnmálafræðideild,Doktorspróf,0,1,1
1239,2016,Viðskiptafræðideild,,121,194,315
1240,2016,Viðskiptafræðideild,Grunnnám,77,74,151
1241,2016,Viðskiptafræðideild,Viðbótarnám,16,13,29
1242,2016,Viðskiptafræðideild,Meistarapróf,28,106,134
1243,2016,Viðskiptafræðideild,Doktorspróf,0,1,1
1244,2016,Hjúkrunarfræðideild,,7,95,102
1245,2016,Hjúkrunarfræðideild,Grunnnám,1,63,64
1246,2016,Hjúkrunarfræðideild,Viðbótarnám,4,14,18
1247,2016,Hjúkrunarfræðideild,Meistarapróf,2,14,16
1248,2016,Hjúkrunarfræðideild,Doktorspróf,0,4,4
1249,2016,Lyfjafræðideild,,16,36,52
1250,2016,Lyfjafræðideild,Grunnnám,10,16,26
1251,2016,Lyfjafræðideild,Viðbótarnám,6,18,24
1252,2016,Lyfjafræðideild,Meistarapróf,0,0,0
1253,2016,Lyfjafræðideild,Doktorspróf,0,2,2
1254,2016,Læknadeild,,64,114,178
1255,2016,Læknadeild,Grunnnám,29,60,89
1256,2016,Læknadeild,Viðbótarnám,23,33,56
1257,2016,Læknadeild,Meistarapróf,9,16,25
1258,2016,Læknadeild,Doktorspróf,3,5,8
1259,2016,Lýðheilsuvísindi,,3,19,22
1260,2016,Lýðheilsuvísindi,Grunnnám,0,0,0
1261,2016,Lýðheilsuvísindi,Viðbótarnám,2,9,11
1262,2016,Lýðheilsuvísindi,Meistarapróf,1,5,6
1263,2016,Lýðheilsuvísindi,Doktorspróf,0,5,5
1264,2016,Matvæla- og næringarfræðideild,,6,33,39
1265,2016,Matvæla- og næringarfræðideild,Grunnnám,3,19,22
1266,2016,Matvæla- og næringarfræðideild,Viðbótarnám,3,13,16
1267,2016,Matvæla- og næringarfræðideild,Meistarapróf,0,0,0
1268,2016,Matvæla- og næringarfræðideild,Doktorspróf,0,1,1
1269,2016,Sálfræðideild,,38,92,130
1270,2016,Sálfræðideild,Grunnnám,31,75,106
1271,2016,Sálfræðideild,Viðbótarnám,7,16,23
1272,2016,Sálfræðideild,Meistarapróf,0,0,0
1273,2016,Sálfræðideild,Doktorspróf,0,1,1
1274,2016,Tannlæknadeild,,6,7,13
1275,2016,Tannlæknadeild,Grunnnám,5,7,12
1276,2016,Tannlæknadeild,Viðbótarnám,0,0,0
1277,2016,Tannlæknadeild,Meistarapróf,1,0,1
1278,2016,Tannlæknadeild,Doktorspróf,0,0,0
1279,2016,"Deild erlendra tungumála, bókmennta og málvísinda",,29,92,121
1280,2016,"Deild erlendra tungumála, bókmennta og málvísinda",Grunnnám,22,60,82
1281,2016,"Deild erlendra tungumála, bókmennta og málvísinda",Viðbótarnám,3,11,14
1282,2016,"Deild erlendra tungumála, bókmennta og málvísinda",Meistarapróf,4,20,24
1283,2016,"Deild erlendra tungumála, bókmennta og málvísinda",Doktorspróf,0,1,1
1284,2016,Guðfræði- og trúarbragðafræðideild,,9,7,16
1285,2016,Guðfræði- og trúarbragðafræðideild,Grunnnám,5,4,9
1286,2016,Guðfræði- og trúarbragðafræðideild,Viðbótarnám,0,2,2
1287,2016,Guðfræði- og trúarbragðafræðideild,Meistarapróf,3,0,3
1288,2016,Guðfræði- og trúarbragðafræðideild,Doktorspróf,1,1,2
1289,2016,Íslensku- og menningardeild,,47,131,178
1290,2016,Íslensku- og menningardeild,Grunnnám,22,80,102
1291,2016,Íslensku- og menningardeild,Viðbótarnám,0,2,2
1292,2016,Íslensku- og menningardeild,Meistarapróf,22,46,68
1293,2016,Íslensku- og menningardeild,Doktorspróf,3,3,6
1294,2016,Sagnfræði- og heimspekideild,,34,39,69
1295,2016,Sagnfræði- og heimspekideild,Grunnnám,20,19,35
1296,2016,Sagnfræði- og heimspekideild,Viðbótarnám,0,1,1
1297,2016,Sagnfræði- og heimspekideild,Meistarapróf,13,16,29
1298,2016,Sagnfræði- og heimspekideild,Doktorspróf,1,3,4
1299,2016,"Íþrótta-, tómstunda- og þroskaþjálfadeild",,28,98,126
1300,2016,"Íþrótta-, tómstunda- og þroskaþjálfadeild",Grunnnám,20,80,100
1301,2016,"Íþrótta-, tómstunda- og þroskaþjálfadeild",Viðbótarnám,0,4,4
1302,2016,"Íþrótta-, tómstunda- og þroskaþjálfadeild",Meistarapróf,8,14,22
1303,2016,"Íþrótta-, tómstunda- og þroskaþjálfadeild",Doktorspróf,0,0,0
1304,2016,Kennaradeild,,31,201,232
1305,2016,Kennaradeild,Grunnnám,18,92,110
1306,2016,Kennaradeild,Viðbótarnám,8,32,40
1307,2016,Kennaradeild,Meistarapróf,5,77,82
1308,2016,Kennaradeild,Doktorspróf,0,0,0
1309,2016,Uppeldis- og menntunarfræðideild,,10,125,135
1310,2016,Uppeldis- og menntunarfræðideild,Grunnnám,5,44,49
1311,2016,Uppeldis- og menntunarfræðideild,Viðbótarnám,2,38,40
1312,2016,Uppeldis- og menntunarfræðideild,Meistarapróf,3,39,42
1313,2016,Uppeldis- og menntunarfræðideild,Doktorspróf,0,4,4
1314,2016,"Iðnaðarverkfræði-, vélaverkfræði- og tölvunarfræðideild",,158,46,204
1315,2016,"Iðnaðarverkfræði-, vélaverkfræði- og tölvunarfræðideild",Grunnnám,140,40,180
1316,2016,"Iðnaðarverkfræði-, vélaverkfræði- og tölvunarfræðideild",Viðbótarnám,0,0,0
1317,2016,"Iðnaðarverkfræði-, vélaverkfræði- og tölvunarfræðideild",Meistarapróf,18,3,21
1318,2016,"Iðnaðarverkfræði-, vélaverkfræði- og tölvunarfræðideild",Doktorspróf,0,3,3
1319,2016,Jarðvísindadeild,,21,18,39
1320,2016,Jarðvísindadeild,Grunnnám,13,11,24
1321,2016,Jarðvísindadeild,Viðbótarnám,0,0,0
1322,2016,Jarðvísindadeild,Meistarapróf,5,5,10
1323,2016,Jarðvísindadeild,Doktorspróf,3,2,5
1324,2016,Líf- og umhverfisvísindadeild,,38,71,109
1325,2016,Líf- og umhverfisvísindadeild,Grunnnám,21,58,79
1326,2016,Líf- og umhverfisvísindadeild,Viðbótarnám,0,0,0
1327,2016,Líf- og umhverfisvísindadeild,Meistarapróf,11,10,21
1328,2016,Líf- og umhverfisvísindadeild,Doktorspróf,6,3,9
1329,2016,Umhverfis- og auðlindafræði,,5,7,12
1330,2016,Umhverfis- og auðlindafræði,Grunnnám,0,0,0
1331,2016,Umhverfis- og auðlindafræði,Viðbótarnám,0,0,0
1332,2016,Umhverfis- og auðlindafræði,Meistarapróf,4,6,10
1333,2016,Umhverfis- og auðlindafræði,Doktorspróf,1,1,2
1334,2016,Rafmagns- og tölvuverkfræðideild,,27,2,29
1335,2016,Rafmagns- og tölvuverkfræðideild,Grunnnám,26,2,28
1336,2016,Rafmagns- og tölvuverkfræðideild,Viðbótarnám,0,0,0
1337,2016,Rafmagns- og tölvuverkfræðideild,Meistarapróf,0,0,0
1338,2016,Rafmagns- og tölvuverkfræðideild,Doktorspróf,1,0,1
1339,2016,Raunvísindadeild,,38,27,65
1340,2016,Raunvísindadeild,Grunnnám,32,23,55
1341,2016,Raunvísindadeild,Viðbótarnám,0,0,0
1342,2016,Raunvísindadeild,Meistarapróf,2,4,6
1343,2016,Raunvísindadeild,Doktorspróf,4,0,4
1344,2016,Umhverfis- og byggingaverkfræðideild,,22,18,40
1345,2016,Umhverfis- og byggingaverkfræðideild,Grunnnám,13,11,24
1346,2016,Umhverfis- og byggingaverkfræðideild,Viðbótarnám,0,0,0
1347,2016,Umhverfis- og byggingaverkfræðideild,Meistarapróf,9,5,14
1348,2016,Umhverfis- og byggingaverkfræðideild,Doktorspróf,0,2,2
1349,2017,Félags- og mannvísindadeild,,37,176,213
1350,2017,Félags- og mannvísindadeild,Grunnnám,23,75,98
1351,2017,Félags- og mannvísindadeild,Viðbótarnám,4,38,42
1352,2017,Félags- og mannvísindadeild,Meistarapróf,9,59,68
1353,2017,Félags- og mannvísindadeild,Doktorspróf,1,4,5
1354,2017,Félagsráðgjafardeild,,9,108,117
1355,2017,Félagsráðgjafardeild,Grunnnám,2,57,59
1356,2017,Félagsráðgjafardeild,Viðbótarnám,4,20,24
1357,2017,Félagsráðgjafardeild,Meistarapróf,3,31,34
1358,2017,Félagsráðgjafardeild,Doktorspróf,0,0,0
1359,2017,Hagfræðideild,,17,17,34
1360,2017,Hagfræðideild,Grunnnám,14,12,26
1361,2017,Hagfræðideild,Viðbótarnám,0,1,1
1362,2017,Hagfræðideild,Meistarapróf,3,3,6
1363,2017,Hagfræðideild,Doktorspróf,0,1,1
1364,2017,Lagadeild,,73,65,138
1365,2017,Lagadeild,Grunnnám,35,33,68
1366,2017,Lagadeild,Viðbótarnám,0,0,0
1367,2017,Lagadeild,Meistarapróf,37,32,69
1368,2017,Lagadeild,Doktorspróf,1,0,1
1369,2017,Stjórnmálafræðideild,,49,113,162
1370,2017,Stjórnmálafræðideild,Grunnnám,22,28,50
1371,2017,Stjórnmálafræðideild,Viðbótarnám,18,51,69
1372,2017,Stjórnmálafræðideild,Meistarapróf,9,33,42
1373,2017,Stjórnmálafræðideild,Doktorspróf,0,1,1
1374,2017,Viðskiptafræðideild,,125,186,311
1375,2017,Viðskiptafræðideild,Grunnnám,71,74,145
1376,2017,Viðskiptafræðideild,Viðbótarnám,0,0,0
1377,2017,Viðskiptafræðideild,Meistarapróf,54,112,166
1378,2017,Viðskiptafræðideild,Doktorspróf,0,0,0
1379,2017,Hjúkrunarfræðideild,,0,171,171
1380,2017,Hjúkrunarfræðideild,Grunnnám,0,78,78
1381,2017,Hjúkrunarfræðideild,Viðbótarnám,0,79,79
1382,2017,Hjúkrunarfræðideild,Meistarapróf,0,12,12
1383,2017,Hjúkrunarfræðideild,Doktorspróf,0,2,2
1384,2017,Lyfjafræðideild,,11,46,57
1385,2017,Lyfjafræðideild,Grunnnám,7,21,28
1386,2017,Lyfjafræðideild,Viðbótarnám,0,0,0
1387,2017,Lyfjafræðideild,Meistarapróf,3,22,25
1388,2017,Lyfjafræðideild,Doktorspróf,1,3,4
1389,2017,Læknadeild,,73,141,214
1390,2017,Læknadeild,Grunnnám,41,86,127
1391,2017,Læknadeild,Viðbótarnám,26,32,58
1392,2017,Læknadeild,Meistarapróf,6,13,19
1393,2017,Læknadeild,Doktorspróf,0,10,10
1394,2017,Lýðheilsuvísindi,,1,20,21
1395,2017,Lýðheilsuvísindi,Grunnnám,0,0,0
1396,2017,Lýðheilsuvísindi,Viðbótarnám,0,12,12
1397,2017,Lýðheilsuvísindi,Meistarapróf,1,6,7
1398,2017,Lýðheilsuvísindi,Doktorspróf,0,2,2
1399,2017,Matvæla- og næringarfræðideild,,4,12,16
1400,2017,Matvæla- og næringarfræðideild,Grunnnám,4,11,15
1401,2017,Matvæla- og næringarfræðideild,Viðbótarnám,0,0,0
1402,2017,Matvæla- og næringarfræðideild,Meistarapróf,0,0,0
1403,2017,Matvæla- og næringarfræðideild,Doktorspróf,0,1,1
1404,2017,Sálfræðideild,,20,96,116
1405,2017,Sálfræðideild,Grunnnám,16,77,93
1406,2017,Sálfræðideild,Viðbótarnám,0,0,0
1407,2017,Sálfræðideild,Meistarapróf,4,19,23
1408,2017,Sálfræðideild,Doktorspróf,0,0,0
1409,2017,Tannlæknadeild,,1,11,12
1410,2017,Tannlæknadeild,Grunnnám,1,10,11
1411,2017,Tannlæknadeild,Viðbótarnám,0,0,0
1412,2017,Tannlæknadeild,Meistarapróf,0,1,1
1413,2017,Tannlæknadeild,Doktorspróf,0,0,0
1414,2017,"Deild erlendra tungumála, bókmennta og málvísinda",,27,88,115
1415,2017,"Deild erlendra tungumála, bókmennta og málvísinda",Grunnnám,24,75,99
1416,2017,"Deild erlendra tungumála, bókmennta og málvísinda",Viðbótarnám,0,0,0
1417,2017,"Deild erlendra tungumála, bókmennta og málvísinda",Meistarapróf,3,13,16
1418,2017,"Deild erlendra tungumála, bókmennta og málvísinda",Doktorspróf,0,0,0
1419,2017,Guðfræði- og trúarbragðafræðideild,,9,19,28
1420,2017,Guðfræði- og trúarbragðafræðideild,Grunnnám,5,8,13
1421,2017,Guðfræði- og trúarbragðafræðideild,Viðbótarnám,0,4,4
1422,2017,Guðfræði- og trúarbragðafræðideild,Meistarapróf,4,7,11
1423,2017,Guðfræði- og trúarbragðafræðideild,Doktorspróf,0,0,0
1424,2017,Íslensku- og menningardeild,,71,162,233
1425,2017,Íslensku- og menningardeild,Grunnnám,45,116,161
1426,2017,Íslensku- og menningardeild,Viðbótarnám,0,5,5
1427,2017,Íslensku- og menningardeild,Meistarapróf,24,39,63
1428,2017,Íslensku- og menningardeild,Doktorspróf,2,2,4
1429,2017,Sagnfræði- og heimspekideild,,48,49,80
1430,2017,Sagnfræði- og heimspekideild,Grunnnám,27,25,35
1431,2017,Sagnfræði- og heimspekideild,Viðbótarnám,3,12,15
1432,2017,Sagnfræði- og heimspekideild,Meistarapróf,18,11,29
1433,2017,Sagnfræði- og heimspekideild,Doktorspróf,0,1,1
1434,2017,"Íþrótta-, tómstunda- og þroskaþjálfadeild",,32,71,103
1435,2017,"Íþrótta-, tómstunda- og þroskaþjálfadeild",Grunnnám,27,59,86
1436,2017,"Íþrótta-, tómstunda- og þroskaþjálfadeild",Viðbótarnám,0,5,5
1437,2017,"Íþrótta-, tómstunda- og þroskaþjálfadeild",Meistarapróf,5,7,12
1438,2017,"Íþrótta-, tómstunda- og þroskaþjálfadeild",Doktorspróf,0,0,0
1439,2017,Kennaradeild,,42,189,231
1440,2017,Kennaradeild,Grunnnám,14,68,82
1441,2017,Kennaradeild,Viðbótarnám,9,44,53
1442,2017,Kennaradeild,Meistarapróf,19,77,96
1443,2017,Kennaradeild,Doktorspróf,0,0,0
1444,2017,Uppeldis- og menntunarfræðideild,,7,100,107
1445,2017,Uppeldis- og menntunarfræðideild,Grunnnám,4,28,32
1446,2017,Uppeldis- og menntunarfræðideild,Viðbótarnám,0,40,40
1447,2017,Uppeldis- og menntunarfræðideild,Meistarapróf,2,28,30
1448,2017,Uppeldis- og menntunarfræðideild,Doktorspróf,1,4,5
1449,2017,"Iðnaðarverkfræði-, vélaverkfræði- og tölvunarfræðideild",,131,65,196
1450,2017,"Iðnaðarverkfræði-, vélaverkfræði- og tölvunarfræðideild",Grunnnám,112,60,172
1451,2017,"Iðnaðarverkfræði-, vélaverkfræði- og tölvunarfræðideild",Viðbótarnám,0,0,0
1452,2017,"Iðnaðarverkfræði-, vélaverkfræði- og tölvunarfræðideild",Meistarapróf,18,5,23
1453,2017,"Iðnaðarverkfræði-, vélaverkfræði- og tölvunarfræðideild",Doktorspróf,1,0,1
1454,2017,Jarðvísindadeild,,16,19,35
1455,2017,Jarðvísindadeild,Grunnnám,10,10,20
1456,2017,Jarðvísindadeild,Viðbótarnám,0,0,0
1457,2017,Jarðvísindadeild,Meistarapróf,4,4,8
1458,2017,Jarðvísindadeild,Doktorspróf,2,5,7
1459,2017,Líf- og umhverfisvísindadeild,,29,81,110
1460,2017,Líf- og umhverfisvísindadeild,Grunnnám,24,66,90
1461,2017,Líf- og umhverfisvísindadeild,Viðbótarnám,0,0,0
1462,2017,Líf- og umhverfisvísindadeild,Meistarapróf,4,12,16
1463,2017,Líf- og umhverfisvísindadeild,Doktorspróf,1,3,4
1464,2017,Umhverfis- og auðlindafræði,,13,10,23
1465,2017,Umhverfis- og auðlindafræði,Grunnnám,0,0,0
1466,2017,Umhverfis- og auðlindafræði,Viðbótarnám,0,0,0
1467,2017,Umhverfis- og auðlindafræði,Meistarapróf,13,10,23
1468,2017,Umhverfis- og auðlindafræði,Doktorspróf,0,0,0
1469,2017,Rafmagns- og tölvuverkfræðideild,,20,5,25
1470,2017,Rafmagns- og tölvuverkfræðideild,Grunnnám,19,5,24
1471,2017,Rafmagns- og tölvuverkfræðideild,Viðbótarnám,0,0,0
1472,2017,Rafmagns- og tölvuverkfræðideild,Meistarapróf,0,0,0
1473,2017,Rafmagns- og tölvuverkfræðideild,Doktorspróf,1,0,1
1474,2017,Raunvísindadeild,,43,19,62
1475,2017,Raunvísindadeild,Grunnnám,33,17,50
1476,2017,Raunvísindadeild,Viðbótarnám,0,0,0
1477,2017,Raunvísindadeild,Meistarapróf,2,0,2
1478,2017,Raunvísindadeild,Doktorspróf,8,2,10
1479,2017,Umhverfis- og byggingaverkfræðideild,,13,13,26
1480,2017,Umhverfis- og byggingaverkfræðideild,Grunnnám,4,9,13
1481,2017,Umhverfis- og byggingaverkfræðideild,Viðbótarnám,0,0,0
1482,2017,Umhverfis- og byggingaverkfræðideild,Meistarapróf,9,3,12
1483,2017,Umhverfis- og byggingaverkfræðideild,Doktorspróf,0,1,1
1484,2018,Félags- og mannvísindadeild,,41,125,166
1485,2018,Félags- og mannvísindadeild,Grunnnám,21,51,72
1486,2018,Félags- og mannvísindadeild,Viðbótarnám,7,31,38
1487,2018,Félags- og mannvísindadeild,Meistarapróf,8,38,46
1488,2018,Félags- og mannvísindadeild,Doktorspróf,5,5,10
1489,2018,Félagsráðgjafardeild,,8,130,138
1490,2018,Félagsráðgjafardeild,Grunnnám,4,73,77
1491,2018,Félagsráðgjafardeild,Viðbótarnám,1,31,32
1492,2018,Félagsráðgjafardeild,Meistarapróf,3,26,29
1493,2018,Félagsráðgjafardeild,Doktorspróf,0,0,0
1494,2018,Hagfræðideild,,13,16,29
1495,2018,Hagfræðideild,Grunnnám,8,13,21
1496,2018,Hagfræðideild,Viðbótarnám,0,0,0
1497,2018,Hagfræðideild,Meistarapróf,4,3,7
1498,2018,Hagfræðideild,Doktorspróf,1,0,1
1499,2018,Lagadeild,,57,98,155
1500,2018,Lagadeild,Grunnnám,27,43,70
1501,2018,Lagadeild,Viðbótarnám,0,0,0
1502,2018,Lagadeild,Meistarapróf,30,54,84
1503,2018,Lagadeild,Doktorspróf,0,1,1
1504,2018,Stjórnmálafræðideild,,24,41,65
1505,2018,Stjórnmálafræðideild,Grunnnám,14,22,36
1506,2018,Stjórnmálafræðideild,Viðbótarnám,0,0,0
1507,2018,Stjórnmálafræðideild,Meistarapróf,10,19,29
1508,2018,Stjórnmálafræðideild,Doktorspróf,0,0,0
1509,2018,Viðskiptafræðideild,,116,177,293
1510,2018,Viðskiptafræðideild,Grunnnám,69,81,150
1511,2018,Viðskiptafræðideild,Viðbótarnám,0,0,0
1512,2018,Viðskiptafræðideild,Meistarapróf,47,95,142
1513,2018,Viðskiptafræðideild,Doktorspróf,0,1,1
1514,2018,Hjúkrunarfræðideild,,1,117,118
1515,2018,Hjúkrunarfræðideild,Grunnnám,0,66,66
1516,2018,Hjúkrunarfræðideild,Viðbótarnám,0,36,36
1517,2018,Hjúkrunarfræðideild,Meistarapróf,1,14,15
1518,2018,Hjúkrunarfræðideild,Doktorspróf,0,1,1
1519,2018,Lyfjafræðideild,,17,43,60
1520,2018,Lyfjafræðideild,Grunnnám,11,23,34
1521,2018,Lyfjafræðideild,Viðbótarnám,0,0,0
1522,2018,Lyfjafræðideild,Meistarapróf,6,17,23
1523,2018,Lyfjafræðideild,Doktorspróf,0,3,3
1524,2018,Læknadeild,,55,138,193
1525,2018,Læknadeild,Grunnnám,27,83,110
1526,2018,Læknadeild,Viðbótarnám,21,41,62
1527,2018,Læknadeild,Meistarapróf,4,13,17
1528,2018,Læknadeild,Doktorspróf,3,1,4
1529,2018,Lýðheilsuvísindi,,3,22,25
1530,2018,Lýðheilsuvísindi,Grunnnám,0,0,0
1531,2018,Lýðheilsuvísindi,Viðbótarnám,2,14,16
1532,2018,Lýðheilsuvísindi,Meistarapróf,1,8,9
1533,2018,Lýðheilsuvísindi,Doktorspróf,0,0,0
1534,2018,Matvæla- og næringarfræðideild,,5,28,33
1535,2018,Matvæla- og næringarfræðideild,Grunnnám,4,14,18
1536,2018,Matvæla- og næringarfræðideild,Viðbótarnám,0,0,0
1537,2018,Matvæla- og næringarfræðideild,Meistarapróf,1,10,11
1538,2018,Matvæla- og næringarfræðideild,Doktorspróf,0,4,4
1539,2018,Sálfræðideild,,22,78,100
1540,2018,Sálfræðideild,Grunnnám,17,55,72
1541,2018,Sálfræðideild,Viðbótarnám,0,0,0
1542,2018,Sálfræðideild,Meistarapróf,4,20,24
1543,2018,Sálfræðideild,Doktorspróf,1,3,4
1544,2018,Tannlæknadeild,,5,7,12
1545,2018,Tannlæknadeild,Grunnnám,4,7,11
1546,2018,Tannlæknadeild,Viðbótarnám,0,0,0
1547,2018,Tannlæknadeild,Meistarapróf,1,0,1
1548,2018,Tannlæknadeild,Doktorspróf,0,0,0
1549,2018,"Deild erlendra tungumála, bókmennta og málvísinda",,41,88,129
1550,2018,"Deild erlendra tungumála, bókmennta og málvísinda",Grunnnám,31,63,94
1551,2018,"Deild erlendra tungumála, bókmennta og málvísinda",Viðbótarnám,4,19,23
1552,2018,"Deild erlendra tungumála, bókmennta og málvísinda",Meistarapróf,6,6,12
1553,2018,"Deild erlendra tungumála, bókmennta og málvísinda",Doktorspróf,0,0,0
1554,2018,Guðfræði- og trúarbragðafræðideild,,6,3,9
1555,2018,Guðfræði- og trúarbragðafræðideild,Grunnnám,4,1,5
1556,2018,Guðfræði- og trúarbragðafræðideild,Viðbótarnám,0,0,0
1557,2018,Guðfræði- og trúarbragðafræðideild,Meistarapróf,2,2,4
1558,2018,Guðfræði- og trúarbragðafræðideild,Doktorspróf,0,0,0
1559,2018,Íslensku- og menningardeild,,61,153,214
1560,2018,Íslensku- og menningardeild,Grunnnám,45,102,147
1561,2018,Íslensku- og menningardeild,Viðbótarnám,1,3,4
1562,2018,Íslensku- og menningardeild,Meistarapróf,15,47,62
1563,2018,Íslensku- og menningardeild,Doktorspróf,0,1,1
1564,2018,Sagnfræði- og heimspekideild,,52,44,82
1565,2018,Sagnfræði- og heimspekideild,Grunnnám,33,16,35
1566,2018,Sagnfræði- og heimspekideild,Viðbótarnám,4,5,9
1567,2018,Sagnfræði- og heimspekideild,Meistarapróf,12,21,33
1568,2018,Sagnfræði- og heimspekideild,Doktorspróf,3,2,5
1569,2018,"Íþrótta-, tómstunda- og þroskaþjálfadeild",,14,89,103
1570,2018,"Íþrótta-, tómstunda- og þroskaþjálfadeild",Grunnnám,12,78,90
1571,2018,"Íþrótta-, tómstunda- og þroskaþjálfadeild",Viðbótarnám,0,1,1
1572,2018,"Íþrótta-, tómstunda- og þroskaþjálfadeild",Meistarapróf,2,10,12
1573,2018,"Íþrótta-, tómstunda- og þroskaþjálfadeild",Doktorspróf,0,0,0
1574,2018,Kennaradeild,,46,178,224
1575,2018,Kennaradeild,Grunnnám,17,78,95
1576,2018,Kennaradeild,Viðbótarnám,15,21,36
1577,2018,Kennaradeild,Meistarapróf,14,79,93
1578,2018,Kennaradeild,Doktorspróf,0,0,0
1579,2018,Uppeldis- og menntunarfræðideild,,5,135,140
1580,2018,Uppeldis- og menntunarfræðideild,Grunnnám,1,39,40
1581,2018,Uppeldis- og menntunarfræðideild,Viðbótarnám,2,45,47
1582,2018,Uppeldis- og menntunarfræðideild,Meistarapróf,1,48,49
1583,2018,Uppeldis- og menntunarfræðideild,Doktorspróf,1,3,4
1584,2018,"Iðnaðarverkfræði-, vélaverkfræði- og tölvunarfræðideild",,112,40,152
1585,2018,"Iðnaðarverkfræði-, vélaverkfræði- og tölvunarfræðideild",Grunnnám,99,31,130
1586,2018,"Iðnaðarverkfræði-, vélaverkfræði- og tölvunarfræðideild",Viðbótarnám,0,0,0
1587,2018,"Iðnaðarverkfræði-, vélaverkfræði- og tölvunarfræðideild",Meistarapróf,13,9,22
1588,2018,"Iðnaðarverkfræði-, vélaverkfræði- og tölvunarfræðideild",Doktorspróf,0,0,0
1589,2018,Jarðvísindadeild,,17,26,43
1590,2018,Jarðvísindadeild,Grunnnám,6,13,19
1591,2018,Jarðvísindadeild,Viðbótarnám,0,0,0
1592,2018,Jarðvísindadeild,Meistarapróf,7,12,19
1593,2018,Jarðvísindadeild,Doktorspróf,4,1,5
1594,2018,Líf- og umhverfisvísindadeild,,20,44,64
1595,2018,Líf- og umhverfisvísindadeild,Grunnnám,16,42,58
1596,2018,Líf- og umhverfisvísindadeild,Viðbótarnám,0,0,0
1597,2018,Líf- og umhverfisvísindadeild,Meistarapróf,1,0,1
1598,2018,Líf- og umhverfisvísindadeild,Doktorspróf,3,2,5
1599,2018,Umhverfis- og auðlindafræði,,13,17,30
1600,2018,Umhverfis- og auðlindafræði,Grunnnám,0,0,0
1601,2018,Umhverfis- og auðlindafræði,Viðbótarnám,0,0,0
1602,2018,Umhverfis- og auðlindafræði,Meistarapróf,13,17,30
1603,2018,Umhverfis- og auðlindafræði,Doktorspróf,0,0,0
1604,2018,Rafmagns- og tölvuverkfræðideild,,18,3,21
1605,2018,Rafmagns- og tölvuverkfræðideild,Grunnnám,17,3,20
1606,2018,Rafmagns- og tölvuverkfræðideild,Viðbótarnám,0,0,0
1607,2018,Rafmagns- og tölvuverkfræðideild,Meistarapróf,1,0,1
1608,2018,Rafmagns- og tölvuverkfræðideild,Doktorspróf,0,0,0
1609,2018,Raunvísindadeild,,49,28,77
1610,2018,Raunvísindadeild,Grunnnám,32,23,55
1611,2018,Raunvísindadeild,Viðbótarnám,0,0,0
1612,2018,Raunvísindadeild,Meistarapróf,13,4,17
1613,2018,Raunvísindadeild,Doktorspróf,4,1,5
1614,2018,Umhverfis- og byggingaverkfræðideild,,14,13,27
1615,2018,Umhverfis- og byggingaverkfræðideild,Grunnnám,11,8,19
1616,2018,Umhverfis- og byggingaverkfræðideild,Viðbótarnám,0,0,0
1617,2018,Umhverfis- og byggingaverkfræðideild,Meistarapróf,3,2,5
1618,2018,Umhverfis- og byggingaverkfræðideild,Doktorspróf,0,3,3
1619,2019,Félags- og mannvísindadeild,,18,147,165
1620,2019,Félags- og mannvísindadeild,Grunnnám,10,55,65
1621,2019,Félags- og mannvísindadeild,Viðbótarnám,4,40,44
1622,2019,Félags- og mannvísindadeild,Meistarapróf,4,44,48
1623,2019,Félags- og mannvísindadeild,Doktorspróf,0,8,8
1624,2019,Félagsráðgjafardeild,,4,81,85
1625,2019,Félagsráðgjafardeild,Grunnnám,3,34,37
1626,2019,Félagsráðgjafardeild,Viðbótarnám,0,13,13
1627,2019,Félagsráðgjafardeild,Meistarapróf,1,34,35
1628,2019,Félagsráðgjafardeild,Doktorspróf,0,0,0
1629,2019,Hagfræðideild,,20,11,31
1630,2019,Hagfræðideild,Grunnnám,16,6,22
1631,2019,Hagfræðideild,Viðbótarnám,1,0,1
1632,2019,Hagfræðideild,Meistarapróf,3,4,7
1633,2019,Hagfræðideild,Doktorspróf,0,1,1
1634,2019,Lagadeild,,67,117,184
1635,2019,Lagadeild,Grunnnám,18,29,47
1636,2019,Lagadeild,Viðbótarnám,24,51,75
1637,2019,Lagadeild,Meistarapróf,25,36,61
1638,2019,Lagadeild,Doktorspróf,0,1,1
1639,2019,Stjórnmálafræðideild,,61,106,167
1640,2019,Stjórnmálafræðideild,Grunnnám,26,22,48
1641,2019,Stjórnmálafræðideild,Viðbótarnám,24,51,75
1642,2019,Stjórnmálafræðideild,Meistarapróf,11,31,42
1643,2019,Stjórnmálafræðideild,Doktorspróf,0,2,2
1644,2019,Viðskiptafræðideild,,108,162,270
1645,2019,Viðskiptafræðideild,Grunnnám,47,61,108
1646,2019,Viðskiptafræðideild,Viðbótarnám,11,15,26
1647,2019,Viðskiptafræðideild,Meistarapróf,50,86,136
1648,2019,Viðskiptafræðideild,Doktorspróf,0,0,0
1649,2019,Hjúkrunarfræðideild,,5,128,133
1650,2019,Hjúkrunarfræðideild,Grunnnám,3,56,59
1651,2019,Hjúkrunarfræðideild,Viðbótarnám,2,64,66
1652,2019,Hjúkrunarfræðideild,Meistarapróf,0,7,7
1653,2019,Hjúkrunarfræðideild,Doktorspróf,0,1,1
1654,2019,Lyfjafræðideild,,36,75,111
1655,2019,Lyfjafræðideild,Grunnnám,3,16,19
1656,2019,Lyfjafræðideild,Viðbótarnám,21,39,60
1657,2019,Lyfjafræðideild,Meistarapróf,11,18,29
1658,2019,Lyfjafræðideild,Doktorspróf,1,2,3
1659,2019,Læknadeild,,75,147,222
1660,2019,Læknadeild,Grunnnám,29,64,93
1661,2019,Læknadeild,Viðbótarnám,21,39,60
1662,2019,Læknadeild,Meistarapróf,14,30,44
1663,2019,Læknadeild,Doktorspróf,11,14,25
1664,2019,Lýðheilsuvísindi,,1,22,23
1665,2019,Lýðheilsuvísindi,Grunnnám,0,0,0
1666,2019,Lýðheilsuvísindi,Viðbótarnám,0,12,12
1667,2019,Lýðheilsuvísindi,Meistarapróf,0,9,9
1668,2019,Lýðheilsuvísindi,Doktorspróf,1,1,2
1669,2019,Matvæla- og næringarfræðideild,,10,19,29
1670,2019,Matvæla- og næringarfræðideild,Grunnnám,5,4,9
1671,2019,Matvæla- og næringarfræðideild,Viðbótarnám,0,0,0
1672,2019,Matvæla- og næringarfræðideild,Meistarapróf,4,15,19
1673,2019,Matvæla- og næringarfræðideild,Doktorspróf,1,0,1
1674,2019,Sálfræðideild,,36,80,116
1675,2019,Sálfræðideild,Grunnnám,28,59,87
1676,2019,Sálfræðideild,Viðbótarnám,0,0,0
1677,2019,Sálfræðideild,Meistarapróf,6,20,26
1678,2019,Sálfræðideild,Doktorspróf,2,1,3
1679,2019,Tannlæknadeild,,1,10,11
1680,2019,Tannlæknadeild,Grunnnám,0,3,3
1681,2019,Tannlæknadeild,Viðbótarnám,1,6,7
1682,2019,Tannlæknadeild,Meistarapróf,0,1,1
1683,2019,Tannlæknadeild,Doktorspróf,0,0,0
1684,2019,"Deild erlendra tungumála, bókmennta og málvísinda",,31,82,113
1685,2019,"Deild erlendra tungumála, bókmennta og málvísinda",Grunnnám,23,55,78
1686,2019,"Deild erlendra tungumála, bókmennta og málvísinda",Viðbótarnám,7,16,23
1687,2019,"Deild erlendra tungumála, bókmennta og málvísinda",Meistarapróf,1,11,12
1688,2019,"Deild erlendra tungumála, bókmennta og málvísinda",Doktorspróf,0,0,0
1689,2019,Guðfræði- og trúarbragðafræðideild,,13,10,23
1690,2019,Guðfræði- og trúarbragðafræðideild,Grunnnám,4,1,5
1691,2019,Guðfræði- og trúarbragðafræðideild,Viðbótarnám,0,3,3
1692,2019,Guðfræði- og trúarbragðafræðideild,Meistarapróf,8,5,13
1693,2019,Guðfræði- og trúarbragðafræðideild,Doktorspróf,1,1,2
1694,2019,Íslensku- og menningardeild,,80,176,256
1695,2019,Íslensku- og menningardeild,Grunnnám,53,130,183
1696,2019,Íslensku- og menningardeild,Viðbótarnám,0,1,1
1697,2019,Íslensku- og menningardeild,Meistarapróf,22,44,66
1698,2019,Íslensku- og menningardeild,Doktorspróf,5,1,6
1699,2019,Sagnfræði- og heimspekideild,,39,36,61
1700,2019,Sagnfræði- og heimspekideild,Grunnnám,30,19,35
1701,2019,Sagnfræði- og heimspekideild,Viðbótarnám,2,7,9
1702,2019,Sagnfræði- og heimspekideild,Meistarapróf,7,9,16
1703,2019,Sagnfræði- og heimspekideild,Doktorspróf,0,1,1
1704,2019,"Íþrótta-, tómstunda- og þroskaþjálfadeild",,37,75,112
1705,2019,"Íþrótta-, tómstunda- og þroskaþjálfadeild",Grunnnám,30,56,86
1706,2019,"Íþrótta-, tómstunda- og þroskaþjálfadeild",Viðbótarnám,3,12,15
1707,2019,"Íþrótta-, tómstunda- og þroskaþjálfadeild",Meistarapróf,4,7,11
1708,2019,"Íþrótta-, tómstunda- og þroskaþjálfadeild",Doktorspróf,0,0,0
1709,2019,Kennaradeild,,47,190,237
1710,2019,Kennaradeild,Grunnnám,21,65,86
1711,2019,Kennaradeild,Viðbótarnám,0,27,27
1712,2019,Kennaradeild,Meistarapróf,26,98,124
1713,2019,Kennaradeild,Doktorspróf,0,0,0
1714,2019,Uppeldis- og menntunarfræðideild,,6,145,151
1715,2019,Uppeldis- og menntunarfræðideild,Grunnnám,3,72,75
1716,2019,Uppeldis- og menntunarfræðideild,Viðbótarnám,0,37,37
1717,2019,Uppeldis- og menntunarfræðideild,Meistarapróf,2,31,33
1718,2019,Uppeldis- og menntunarfræðideild,Doktorspróf,1,5,6
1719,2019,"Iðnaðarverkfræði-, vélaverkfræði- og tölvunarfræðideild",,114,72,186
1720,2019,"Iðnaðarverkfræði-, vélaverkfræði- og tölvunarfræðideild",Grunnnám,98,62,160
1721,2019,"Iðnaðarverkfræði-, vélaverkfræði- og tölvunarfræðideild",Viðbótarnám,0,0,0
1722,2019,"Iðnaðarverkfræði-, vélaverkfræði- og tölvunarfræðideild",Meistarapróf,13,10,23
1723,2019,"Iðnaðarverkfræði-, vélaverkfræði- og tölvunarfræðideild",Doktorspróf,3,0,3
1724,2019,Jarðvísindadeild,,16,28,44
1725,2019,Jarðvísindadeild,Grunnnám,6,12,18
1726,2019,Jarðvísindadeild,Viðbótarnám,0,0,0
1727,2019,Jarðvísindadeild,Meistarapróf,8,9,17
1728,2019,Jarðvísindadeild,Doktorspróf,2,7,9
1729,2019,Líf- og umhverfisvísindadeild,,31,61,92
1730,2019,Líf- og umhverfisvísindadeild,Grunnnám,23,48,71
1731,2019,Líf- og umhverfisvísindadeild,Viðbótarnám,0,0,0
1732,2019,Líf- og umhverfisvísindadeild,Meistarapróf,4,12,16
1733,2019,Líf- og umhverfisvísindadeild,Doktorspróf,4,1,5
1734,2019,Umhverfis- og auðlindafræði,,2,1,3
1735,2019,Umhverfis- og auðlindafræði,Grunnnám,0,0,0
1736,2019,Umhverfis- og auðlindafræði,Viðbótarnám,0,0,0
1737,2019,Umhverfis- og auðlindafræði,Meistarapróf,0,0,0
1738,2019,Umhverfis- og auðlindafræði,Doktorspróf,2,1,3
1739,2019,Rafmagns- og tölvuverkfræðideild,,15,8,23
1740,2019,Rafmagns- og tölvuverkfræðideild,Grunnnám,13,8,21
1741,2019,Rafmagns- og tölvuverkfræðideild,Viðbótarnám,0,0,0
1742,2019,Rafmagns- og tölvuverkfræðideild,Meistarapróf,2,0,2
1743,2019,Rafmagns- og tölvuverkfræðideild,Doktorspróf,0,0,0
1744,2019,Raunvísindadeild,,45,29,74
1745,2019,Raunvísindadeild,Grunnnám,37,26,63
1746,2019,Raunvísindadeild,Viðbótarnám,0,0,0
1747,2019,Raunvísindadeild,Meistarapróf,3,3,6
1748,2019,Raunvísindadeild,Doktorspróf,5,0,5
1749,2019,Umhverfis- og auðlindafræði,,14,13,27
1750,2019,Umhverfis- og auðlindafræði,Grunnnám,10,8,18
1751,2019,Umhverfis- og auðlindafræði,Viðbótarnám,0,0,0
1752,2019,Umhverfis- og auðlindafræði,Meistarapróf,2,3,5
1753,2019,Umhverfis- og auðlindafræði,Doktorspróf,2,2,4
1754,2020,Félags- og mannvísindadeild,,30,119,149
1755,2020,Félags- og mannvísindadeild,Grunnnám,10,56,66
1756,2020,Félags- og mannvísindadeild,Viðbótarnám,8,26,34
1757,2020,Félags- og mannvísindadeild,Meistarapróf,11,37,48
1758,2020,Félags- og mannvísindadeild,Doktorspróf,1,0,1
1759,2020,Félagsráðgjafardeild,,4,81,85
1760,2020,Félagsráðgjafardeild,Grunnnám,4,39,43
1761,2020,Félagsráðgjafardeild,Viðbótarnám,0,13,13
1762,2020,Félagsráðgjafardeild,Meistarapróf,0,27,27
1763,2020,Félagsráðgjafardeild,Doktorspróf,0,2,2
1764,2020,Hagfræðideild,,33,23,56
1765,2020,Hagfræðideild,Grunnnám,23,19,42
1766,2020,Hagfræðideild,Viðbótarnám,3,3,6
1767,2020,Hagfræðideild,Meistarapróf,7,1,8
1768,2020,Hagfræðideild,Doktorspróf,0,0,0
1769,2020,Lagadeild,,51,56,107
1770,2020,Lagadeild,Grunnnám,21,20,41
1771,2020,Lagadeild,Viðbótarnám,0,0,0
1772,2020,Lagadeild,Meistarapróf,30,36,66
1773,2020,Lagadeild,Doktorspróf,0,0,0
1774,2020,Stjórnmálafræðideild,,40,111,151
1775,2020,Stjórnmálafræðideild,Grunnnám,10,22,32
1776,2020,Stjórnmálafræðideild,Viðbótarnám,24,64,88
1777,2020,Stjórnmálafræðideild,Meistarapróf,6,24,30
1778,2020,Stjórnmálafræðideild,Doktorspróf,0,1,1
1779,2020,Viðskiptafræðideild,,131,188,319
1780,2020,Viðskiptafræðideild,Grunnnám,62,67,129
1781,2020,Viðskiptafræðideild,Viðbótarnám,17,14,31
1782,2020,Viðskiptafræðideild,Meistarapróf,52,107,159
1783,2020,Viðskiptafræðideild,Doktorspróf,0,0,0
1784,2020,Hjúkrunarfræðideild,,7,143,150
1785,2020,Hjúkrunarfræðideild,Grunnnám,3,78,81
1786,2020,Hjúkrunarfræðideild,Viðbótarnám,3,52,55
1787,2020,Hjúkrunarfræðideild,Meistarapróf,1,13,14
1788,2020,Hjúkrunarfræðideild,Doktorspróf,0,0,0
1789,2020,Lyfjafræðideild,,21,39,60
1790,2020,Lyfjafræðideild,Grunnnám,10,13,23
1791,2020,Lyfjafræðideild,Viðbótarnám,0,0,0
1792,2020,Lyfjafræðideild,Meistarapróf,11,24,35
1793,2020,Lyfjafræðideild,Doktorspróf,0,2,2
1794,2020,Læknadeild,,64,161,225
1795,2020,Læknadeild,Grunnnám,35,73,108
1796,2020,Læknadeild,Viðbótarnám,19,44,63
1797,2020,Læknadeild,Meistarapróf,7,35,42
1798,2020,Læknadeild,Doktorspróf,3,9,12
1799,2020,Lýðheilsuvísindi,,4,19,23
1800,2020,Lýðheilsuvísindi,Grunnnám,0,0,0
1801,2020,Lýðheilsuvísindi,Viðbótarnám,2,11,13
1802,2020,Lýðheilsuvísindi,Meistarapróf,2,6,8
1803,2020,Lýðheilsuvísindi,Doktorspróf,0,2,2
1804,2020,Matvæla- og næringarfræðideild,,3,12,15
1805,2020,Matvæla- og næringarfræðideild,Grunnnám,1,4,5
1806,2020,Matvæla- og næringarfræðideild,Viðbótarnám,1,7,8
1807,2020,Matvæla- og næringarfræðideild,Meistarapróf,0,0,0
1808,2020,Matvæla- og næringarfræðideild,Doktorspróf,1,1,2
1809,2020,Sálfræðideild,,16,97,113
1810,2020,Sálfræðideild,Grunnnám,12,73,85
1811,2020,Sálfræðideild,Viðbótarnám,0,0,0
1812,2020,Sálfræðideild,Meistarapróf,4,23,27
1813,2020,Sálfræðideild,Doktorspróf,0,1,1
1814,2020,Tannlæknadeild,,1,11,12
1815,2020,Tannlæknadeild,Grunnnám,0,5,5
1816,2020,Tannlæknadeild,Viðbótarnám,1,5,6
1817,2020,Tannlæknadeild,Meistarapróf,0,1,1
1818,2020,Tannlæknadeild,Doktorspróf,0,0,0
1819,2020,"Deild erlendra tungumála, bókmennta og málvísinda",,34,120,154
1820,2020,"Deild erlendra tungumála, bókmennta og málvísinda",Grunnnám,22,81,103
1821,2020,"Deild erlendra tungumála, bókmennta og málvísinda",Viðbótarnám,6,14,20
1822,2020,"Deild erlendra tungumála, bókmennta og málvísinda",Meistarapróf,5,25,30
1823,2020,"Deild erlendra tungumála, bókmennta og málvísinda",Doktorspróf,1,0,1
1824,2020,Guðfræði- og trúarbragðafræðideild,,7,6,13
1825,2020,Guðfræði- og trúarbragðafræðideild,Grunnnám,0,1,1
1826,2020,Guðfræði- og trúarbragðafræðideild,Viðbótarnám,0,1,1
1827,2020,Guðfræði- og trúarbragðafræðideild,Meistarapróf,6,4,10
1828,2020,Guðfræði- og trúarbragðafræðideild,Doktorspróf,1,0,1
1829,2020,Íslensku- og menningardeild,,74,151,225
1830,2020,Íslensku- og menningardeild,Grunnnám,49,110,159
1831,2020,Íslensku- og menningardeild,Viðbótarnám,1,1,2
1832,2020,Íslensku- og menningardeild,Meistarapróf,22,35,57
1833,2020,Íslensku- og menningardeild,Doktorspróf,2,5,7
1834,2020,Sagnfræði- og heimspekideild,,44,42,74
1835,2020,Sagnfræði- og heimspekideild,Grunnnám,30,17,35
1836,2020,Sagnfræði- og heimspekideild,Viðbótarnám,4,8,12
1837,2020,Sagnfræði- og heimspekideild,Meistarapróf,8,16,24
1838,2020,Sagnfræði- og heimspekideild,Doktorspróf,2,1,3
1839,2020,"Íþrótta-, tómstunda- og þroskaþjálfadeild",,52,101,153
1840,2020,"Íþrótta-, tómstunda- og þroskaþjálfadeild",Grunnnám,45,90,135
1841,2020,"Íþrótta-, tómstunda- og þroskaþjálfadeild",Viðbótarnám,2,4,6
1842,2020,"Íþrótta-, tómstunda- og þroskaþjálfadeild",Meistarapróf,5,7,12
1843,2020,"Íþrótta-, tómstunda- og þroskaþjálfadeild",Doktorspróf,0,0,0
1844,2020,Kennaradeild,,52,196,248
1845,2020,Kennaradeild,Grunnnám,28,40,68
1846,2020,Kennaradeild,Viðbótarnám,9,59,68
1847,2020,Kennaradeild,Meistarapróf,15,97,112
1848,2020,Kennaradeild,Doktorspróf,0,0,0
1849,2020,Uppeldis- og menntunarfræðideild,,14,123,137
1850,2020,Uppeldis- og menntunarfræðideild,Grunnnám,12,75,87
1851,2020,Uppeldis- og menntunarfræðideild,Viðbótarnám,0,26,26
1852,2020,Uppeldis- og menntunarfræðideild,Meistarapróf,1,19,20
1853,2020,Uppeldis- og menntunarfræðideild,Doktorspróf,1,3,4
1854,2020,"Iðnaðarverkfræði-, vélaverkfræði- og tölvunarfræðideild",,124,50,174
1855,2020,"Iðnaðarverkfræði-, vélaverkfræði- og tölvunarfræðideild",Grunnnám,105,42,147
1856,2020,"Iðnaðarverkfræði-, vélaverkfræði- og tölvunarfræðideild",Viðbótarnám,0,0,0
1857,2020,"Iðnaðarverkfræði-, vélaverkfræði- og tölvunarfræðideild",Meistarapróf,18,8,26
1858,2020,"Iðnaðarverkfræði-, vélaverkfræði- og tölvunarfræðideild",Doktorspróf,1,0,1
1859,2020,Jarðvísindadeild,,8,16,24
1860,2020,Jarðvísindadeild,Grunnnám,3,7,10
1861,2020,Jarðvísindadeild,Viðbótarnám,0,0,0
1862,2020,Jarðvísindadeild,Meistarapróf,2,6,8
1863,2020,Jarðvísindadeild,Doktorspróf,3,3,6
1864,2020,Líf- og umhverfisvísindadeild,,29,50,79
1865,2020,Líf- og umhverfisvísindadeild,Grunnnám,19,41,60
1866,2020,Líf- og umhverfisvísindadeild,Viðbótarnám,0,0,0
1867,2020,Líf- og umhverfisvísindadeild,Meistarapróf,8,6,14
1868,2020,Líf- og umhverfisvísindadeild,Doktorspróf,2,3,5
1869,2020,Umhverfis- og auðlindafræði,,0,4,4
1870,2020,Umhverfis- og auðlindafræði,Grunnnám,0,0,0
1871,2020,Umhverfis- og auðlindafræði,Viðbótarnám,0,0,0
1872,2020,Umhverfis- og auðlindafræði,Meistarapróf,0,0,0
1873,2020,Umhverfis- og auðlindafræði,Doktorspróf,0,4,4
1874,2020,Rafmagns- og tölvuverkfræðideild,,16,5,21
1875,2020,Rafmagns- og tölvuverkfræðideild,Grunnnám,13,5,18
1876,2020,Rafmagns- og tölvuverkfræðideild,Viðbótarnám,0,0,0
1877,2020,Rafmagns- og tölvuverkfræðideild,Meistarapróf,3,0,3
1878,2020,Rafmagns- og tölvuverkfræðideild,Doktorspróf,0,0,0
1879,2020,Raunvísindadeild,,48,27,75
1880,2020,Raunvísindadeild,Grunnnám,28,24,52
1881,2020,Raunvísindadeild,Viðbótarnám,0,0,0
1882,2020,Raunvísindadeild,Meistarapróf,11,1,12
1883,2020,Raunvísindadeild,Doktorspróf,9,2,11
1884,2020,Umhverfis- og byggingaverkfræðideild,,13,12,25
1885,2020,Umhverfis- og byggingaverkfræðideild,Grunnnám,9,8,17
1886,2020,Umhverfis- og byggingaverkfræðideild,Viðbótarnám,0,0,0
1887,2020,Umhverfis- og byggingaverkfræðideild,Meistarapróf,4,4,8
1888,2020,Umhverfis- og byggingaverkfræðideild,Doktorspróf,0,0,0
1889,2021,Félags- og mannvísindadeild,,30,134,164
1890,2021,Félags- og mannvísindadeild,Grunnnám,12,50,62
1891,2021,Félags- og mannvísindadeild,Viðbótarnám,8,46,54
1892,2021,Félags- og mannvísindadeild,Meistarapróf,9,38,47
1893,2021,Félags- og mannvísindadeild,Doktorspróf,1,0,1
1894,2021,Félagsráðgjafardeild,,8,115,123
1895,2021,Félagsráðgjafardeild,Grunnnám,6,60,66
1896,2021,Félagsráðgjafardeild,Viðbótarnám,1,24,25
1897,2021,Félagsráðgjafardeild,Meistarapróf,1,31,32
1898,2021,Félagsráðgjafardeild,Doktorspróf,0,0,0
1899,2021,Hagfræðideild,,46,18,64
1900,2021,Hagfræðideild,Grunnnám,36,16,52
1901,2021,Hagfræðideild,Viðbótarnám,2,1,3
1902,2021,Hagfræðideild,Meistarapróf,7,1,8
1903,2021,Hagfræðideild,Doktorspróf,1,0,1
1904,2021,Lagadeild,,39,66,105
1905,2021,Lagadeild,Grunnnám,19,28,47
1906,2021,Lagadeild,Viðbótarnám,19,38,57
1907,2021,Lagadeild,Meistarapróf,0,0,0
1908,2021,Lagadeild,Doktorspróf,1,0,1
1909,2021,Stjórnmálafræðideild,,62,143,205
1910,2021,Stjórnmálafræðideild,Grunnnám,13,13,26
1911,2021,Stjórnmálafræðideild,Viðbótarnám,33,94,127
1912,2021,Stjórnmálafræðideild,Meistarapróf,15,36,51
1913,2021,Stjórnmálafræðideild,Doktorspróf,1,0,1
1914,2021,Viðskiptafræðideild,,124,201,325
1915,2021,Viðskiptafræðideild,Grunnnám,66,90,156
1916,2021,Viðskiptafræðideild,Viðbótarnám,15,18,33
1917,2021,Viðskiptafræðideild,Meistarapróf,42,92,134
1918,2021,Viðskiptafræðideild,Doktorspróf,1,1,2
1919,2021,Hjúkrunarfræðideild,,3,175,178
1920,2021,Hjúkrunarfræðideild,Grunnnám,1,95,96
1921,2021,Hjúkrunarfræðideild,Viðbótarnám,2,48,50
1922,2021,Hjúkrunarfræðideild,Meistarapróf,0,31,31
1923,2021,Hjúkrunarfræðideild,Doktorspróf,0,1,1
1924,2021,Lyfjafræðideild,,12,29,41
1925,2021,Lyfjafræðideild,Grunnnám,7,15,22
1926,2021,Lyfjafræðideild,Viðbótarnám,0,0,0
1927,2021,Lyfjafræðideild,Meistarapróf,5,14,19
1928,2021,Lyfjafræðideild,Doktorspróf,0,0,0
1929,2021,Læknadeild,,79,227,306
1930,2021,Læknadeild,Grunnnám,39,145,184
1931,2021,Læknadeild,Viðbótarnám,19,41,60
1932,2021,Læknadeild,Meistarapróf,15,35,50
1933,2021,Læknadeild,Doktorspróf,6,6,12
1934,2021,Lýðheilsuvísindi,,7,9,16
1935,2021,Lýðheilsuvísindi,Grunnnám,0,0,0
1936,2021,Lýðheilsuvísindi,Viðbótarnám,7,9,16
1937,2021,Lýðheilsuvísindi,Meistarapróf,0,0,0
1938,2021,Lýðheilsuvísindi,Doktorspróf,0,0,0
1939,2021,Matvæla- og næringarfræðideild,,8,22,30
1940,2021,Matvæla- og næringarfræðideild,Grunnnám,5,14,19
1941,2021,Matvæla- og næringarfræðideild,Viðbótarnám,0,0,0
1942,2021,Matvæla- og næringarfræðideild,Meistarapróf,3,8,11
1943,2021,Matvæla- og næringarfræðideild,Doktorspróf,0,0,0
1944,2021,Sálfræðideild,,46,122,168
1945,2021,Sálfræðideild,Grunnnám,39,92,131
1946,2021,Sálfræðideild,Viðbótarnám,0,0,0
1947,2021,Sálfræðideild,Meistarapróf,6,29,35
1948,2021,Sálfræðideild,Doktorspróf,1,1,2
1949,2021,Tannlæknadeild,,4,9,13
1950,2021,Tannlæknadeild,Grunnnám,3,9,12
1951,2021,Tannlæknadeild,Viðbótarnám,0,0,0
1952,2021,Tannlæknadeild,Meistarapróf,0,0,0
1953,2021,Tannlæknadeild,Doktorspróf,1,0,1
1954,2021,"Deild erlendra tungumála, bókmennta og málvísinda",,36,118,154
1955,2021,"Deild erlendra tungumála, bókmennta og málvísinda",Grunnnám,32,84,116
1956,2021,"Deild erlendra tungumála, bókmennta og málvísinda",Viðbótarnám,1,19,20
1957,2021,"Deild erlendra tungumála, bókmennta og málvísinda",Meistarapróf,3,13,16
1958,2021,"Deild erlendra tungumála, bókmennta og málvísinda",Doktorspróf,0,2,2
1959,2021,Guðfræði- og trúarbragðafræðideild,,6,10,16
1960,2021,Guðfræði- og trúarbragðafræðideild,Grunnnám,1,3,4
1961,2021,Guðfræði- og trúarbragðafræðideild,Viðbótarnám,1,1,2
1962,2021,Guðfræði- og trúarbragðafræðideild,Meistarapróf,4,6,10
1963,2021,Guðfræði- og trúarbragðafræðideild,Doktorspróf,0,0,0
1964,2021,Íslensku- og menningardeild,,59,139,198
1965,2021,Íslensku- og menningardeild,Grunnnám,40,103,143
1966,2021,Íslensku- og menningardeild,Viðbótarnám,1,3,4
1967,2021,Íslensku- og menningardeild,Meistarapróf,17,30,47
1968,2021,Íslensku- og menningardeild,Doktorspróf,1,3,4
1969,2021,Sagnfræði- og heimspekideild,,59,54,107
1970,2021,Sagnfræði- og heimspekideild,Grunnnám,30,11,35
1971,2021,Sagnfræði- og heimspekideild,Viðbótarnám,10,22,32
1972,2021,Sagnfræði- og heimspekideild,Meistarapróf,16,20,36
1973,2021,Sagnfræði- og heimspekideild,Doktorspróf,3,1,4
1974,2021,"Íþrótta-, tómstunda- og þroskaþjálfadeild",,35,76,111
1975,2021,"Íþrótta-, tómstunda- og þroskaþjálfadeild",Grunnnám,22,45,67
1976,2021,"Íþrótta-, tómstunda- og þroskaþjálfadeild",Viðbótarnám,9,22,31
1977,2021,"Íþrótta-, tómstunda- og þroskaþjálfadeild",Meistarapróf,4,9,13
1978,2021,"Íþrótta-, tómstunda- og þroskaþjálfadeild",Doktorspróf,0,0,0
1979,2021,Kennaradeild,,80,399,479
1980,2021,Kennaradeild,Grunnnám,27,105,132
1981,2021,Kennaradeild,Viðbótarnám,45,242,287
1982,2021,Kennaradeild,Meistarapróf,8,52,60
1983,2021,Kennaradeild,Doktorspróf,0,0,0
1984,2021,Uppeldis- og menntunarfræðideild,,4,105,109
1985,2021,Uppeldis- og menntunarfræðideild,Grunnnám,3,71,74
1986,2021,Uppeldis- og menntunarfræðideild,Viðbótarnám,0,16,16
1987,2021,Uppeldis- og menntunarfræðideild,Meistarapróf,1,12,13
1988,2021,Uppeldis- og menntunarfræðideild,Doktorspróf,0,6,6
1989,2021,"Iðnaðarverkfræði-, vélaverkfræði- og tölvunarfræðideild",,120,66,186
1990,2021,"Iðnaðarverkfræði-, vélaverkfræði- og tölvunarfræðideild",Grunnnám,103,58,161
1991,2021,"Iðnaðarverkfræði-, vélaverkfræði- og tölvunarfræðideild",Viðbótarnám,0,0,0
1992,2021,"Iðnaðarverkfræði-, vélaverkfræði- og tölvunarfræðideild",Meistarapróf,15,4,19
1993,2021,"Iðnaðarverkfræði-, vélaverkfræði- og tölvunarfræðideild",Doktorspróf,2,4,6
1994,2021,Jarðvísindadeild,,18,21,39
1995,2021,Jarðvísindadeild,Grunnnám,6,9,15
1996,2021,Jarðvísindadeild,Viðbótarnám,0,0,0
1997,2021,Jarðvísindadeild,Meistarapróf,10,10,20
1998,2021,Jarðvísindadeild,Doktorspróf,2,2,4
1999,2021,Líf- og umhverfisvísindadeild,,18,47,65
2000,2021,Líf- og umhverfisvísindadeild,Grunnnám,15,35,50
2001,2021,Líf- og umhverfisvísindadeild,Viðbótarnám,0,0,0
2002,2021,Líf- og umhverfisvísindadeild,Meistarapróf,1,7,8
2003,2021,Líf- og umhverfisvísindadeild,Doktorspróf,2,5,7
2004,2021,Umhverfis- og auðlindafræði,,19,29,48
2005,2021,Umhverfis- og auðlindafræði,Grunnnám,0,0,0
2006,2021,Umhverfis- og auðlindafræði,Viðbótarnám,8,11,19
2007,2021,Umhverfis- og auðlindafræði,Meistarapróf,6,16,22
2008,2021,Umhverfis- og auðlindafræði,Doktorspróf,5,2,7
2009,2021,Rafmagns- og tölvuverkfræðideild,,19,8,27
2010,2021,Rafmagns- og tölvuverkfræðideild,Grunnnám,13,8,21
2011,2021,Rafmagns- og tölvuverkfræðideild,Viðbótarnám,0,0,0
2012,2021,Rafmagns- og tölvuverkfræðideild,Meistarapróf,4,0,4
2013,2021,Rafmagns- og tölvuverkfræðideild,Doktorspróf,2,0,2
2014,2021,Raunvísindadeild,,33,19,52
2015,2021,Raunvísindadeild,Grunnnám,24,15,39
2016,2021,Raunvísindadeild,Viðbótarnám,0,0,0
2017,2021,Raunvísindadeild,Meistarapróf,0,0,0
2018,2021,Raunvísindadeild,Doktorspróf,9,4,13
2019,2021,Umhverfis- og byggingaverkfræðideild,,20,22,42
2020,2021,Umhverfis- og byggingaverkfræðideild,Grunnnám,8,16,24
2021,2021,Umhverfis- og byggingaverkfræðideild,Viðbótarnám,0,0,0
2022,2021,Umhverfis- og byggingaverkfræðideild,Meistarapróf,9,4,13
2023,2021,Umhverfis- og byggingaverkfræðideild,Doktorspróf,3,2,5
