,Year,Braut,tegund_nams,kk,kv,samtals_inn
9,1111,dumyy,dummy,1,1,2
0,2007,Félags- og mannvísindadeild,,150,632,782
1,2007,Félags- og mannvísindadeild,Grunnnám,93,351,444
2,2007,Félags- og mannvísindadeild,Viðbótarnám,13,101,114
3,2007,Félags- og mannvísindadeild,Meistarapróf,37,169,206
4,2007,Félags- og mannvísindadeild,Doktorspróf,7,11,18
5,2007,Félagsráðgjafardeild,,32,279,311
6,2007,Félagsráðgjafardeild,Grunnnám,29,241,270
7,2007,Félagsráðgjafardeild,Viðbótarnám,3,24,27
8,2007,Félagsráðgjafardeild,Meistarapróf,0,13,13
9,2007,Félagsráðgjafardeild,Doktorspróf,0,1,1
10,2007,Hagfræðideild,,185,114,299
11,2007,Hagfræðideild,Grunnnám,134,80,214
12,2007,Hagfræðideild,Viðbótarnám,0,0,0
13,2007,Hagfræðideild,Meistarapróf,47,33,80
14,2007,Hagfræðideild,Doktorspróf,4,1,5
15,2007,Lagadeild,,301,322,623
16,2007,Lagadeild,Grunnnám,208,226,434
17,2007,Lagadeild,Viðbótarnám,0,0,0
18,2007,Lagadeild,Meistarapróf,92,94,186
19,2007,Lagadeild,Doktorspróf,1,2,3
20,2007,Stjórnmálafræðideild,,237,384,621
21,2007,Stjórnmálafræðideild,Grunnnám,125,130,255
22,2007,Stjórnmálafræðideild,Viðbótarnám,18,42,60
23,2007,Stjórnmálafræðideild,Meistarapróf,89,200,289
24,2007,Stjórnmálafræðideild,Doktorspróf,5,12,17
25,2007,Viðskiptafræðideild,,495,673,1168
26,2007,Viðskiptafræðideild,Grunnnám,291,313,604
27,2007,Viðskiptafræðideild,Viðbótarnám,0,0,0
28,2007,Viðskiptafræðideild,Meistarapróf,201,360,561
29,2007,Viðskiptafræðideild,Doktorspróf,3,0,3
30,2007,Hjúkrunarfræðideild,,0,0,0
31,2007,Hjúkrunarfræðideild,Grunnnám,0,0,0
32,2007,Hjúkrunarfræðideild,Viðbótarnám,0,0,0
33,2007,Hjúkrunarfræðideild,Meistarapróf,0,0,0
34,2007,Hjúkrunarfræðideild,Doktorspróf,0,0,0
35,2007,Lyfjafræðideild,,20,42,62
36,2007,Lyfjafræðideild,Grunnnám,0,0,0
37,2007,Lyfjafræðideild,Viðbótarnám,0,0,0
38,2007,Lyfjafræðideild,Meistarapróf,16,38,54
39,2007,Lyfjafræðideild,Doktorspróf,4,4,8
40,2007,Læknadeild,,196,356,552
41,2007,Læknadeild,Grunnnám,164,283,447
42,2007,Læknadeild,Viðbótarnám,0,0,0
43,2007,Læknadeild,Meistarapróf,17,36,53
44,2007,Læknadeild,Doktorspróf,15,37,52
45,2007,Matvæla- og næringarfræðideild,,13,46,59
46,2007,Matvæla- og næringarfræðideild,Grunnnám,8,23,31
47,2007,Matvæla- og næringarfræðideild,Viðbótarnám,0,1,1
48,2007,Matvæla- og næringarfræðideild,Meistarapróf,4,13,17
49,2007,Matvæla- og næringarfræðideild,Doktorspróf,1,9,10
50,2007,Sálfræðideild,,139,390,529
51,2007,Sálfræðideild,Grunnnám,125,347,472
52,2007,Sálfræðideild,Viðbótarnám,0,0,0
53,2007,Sálfræðideild,Meistarapróf,5,10,15
54,2007,Sálfræðideild,Doktorspróf,9,33,42
55,2007,Tannlæknadeild,,17,42,61
56,2007,Tannlæknadeild,Grunnnám,16,41,57
57,2007,Tannlæknadeild,Viðbótarnám,0,0,2
58,2007,Tannlæknadeild,Meistarapróf,1,1,2
59,2007,Tannlæknadeild,Doktorspróf,0,0,0
60,2007,"Deild erlendra tungumála, bókmennta og málvísinda",,175,497,672
61,2007,"Deild erlendra tungumála, bókmennta og málvísinda",Grunnnám,164,460,624
62,2007,"Deild erlendra tungumála, bókmennta og málvísinda",Viðbótarnám,0,0,0
63,2007,"Deild erlendra tungumála, bókmennta og málvísinda",Meistarapróf,11,36,47
64,2007,"Deild erlendra tungumála, bókmennta og málvísinda",Doktorspróf,0,1,1
65,2007,Guðfræði- og trúarbragðafræðideild,,58,96,154
66,2007,Guðfræði- og trúarbragðafræðideild,Grunnnám,33,57,90
67,2007,Guðfræði- og trúarbragðafræðideild,Viðbótarnám,0,17,17
68,2007,Guðfræði- og trúarbragðafræðideild,Meistarapróf,23,18,41
69,2007,Guðfræði- og trúarbragðafræðideild,Doktorspróf,2,4,6
70,2007,Íslensku- og menningardeild,,212,661,873
71,2007,Íslensku- og menningardeild,Grunnnám,177,519,696
72,2007,Íslensku- og menningardeild,Viðbótarnám,0,11,11
73,2007,Íslensku- og menningardeild,Meistarapróf,27,122,149
74,2007,Íslensku- og menningardeild,Doktorspróf,8,9,17
75,2007,Sagnfræði- og heimspekideild,,277,245,522
76,2007,Sagnfræði- og heimspekideild,Grunnnám,220,153,373
77,2007,Sagnfræði- og heimspekideild,Viðbótarnám,1,5,6
78,2007,Sagnfræði- og heimspekideild,Meistarapróf,49,73,122
79,2007,Sagnfræði- og heimspekideild,Doktorspróf,7,14,21
80,2007,"Íþrótta-, tómstunda- og þroskaþjálfadeild",,104,292,396
81,2007,"Íþrótta-, tómstunda- og þroskaþjálfadeild",Grunnnám,49,187,236
82,2007,"Íþrótta-, tómstunda- og þroskaþjálfadeild",Viðbótarnám,5,15,20
83,2007,"Íþrótta-, tómstunda- og þroskaþjálfadeild",Meistarapróf,50,89,139
84,2007,"Íþrótta-, tómstunda- og þroskaþjálfadeild",Doktorspróf,0,1,1
85,2007,Kennaradeild,,241,1228,1469
86,2007,Kennaradeild,Grunnnám,202,830,1032
87,2007,Kennaradeild,Viðbótarnám,15,138,153
88,2007,Kennaradeild,Meistarapróf,22,257,279
89,2007,Kennaradeild,Doktorspróf,2,3,5
90,2007,Uppeldis- og menntunarfræðideild,,43,234,277
91,2007,Uppeldis- og menntunarfræðideild,Grunnnám,23,178,201
92,2007,Uppeldis- og menntunarfræðideild,Viðbótarnám,5,25,30
93,2007,Uppeldis- og menntunarfræðideild,Meistarapróf,14,20,34
94,2007,Uppeldis- og menntunarfræðideild,Doktorspróf,1,11,12
95,2007,"Iðnaðarverkfræði-, vélaverkfræði- og tölvunarfræðideild",,0,0,0
96,2007,"Iðnaðarverkfræði-, vélaverkfræði- og tölvunarfræðideild",Grunnnám,0,0,0
97,2007,"Iðnaðarverkfræði-, vélaverkfræði- og tölvunarfræðideild",Viðbótarnám,0,0,0
98,2007,"Iðnaðarverkfræði-, vélaverkfræði- og tölvunarfræðideild",Meistarapróf,0,0,0
99,2007,"Iðnaðarverkfræði-, vélaverkfræði- og tölvunarfræðideild",Doktorspróf,0,0,0
100,2007,Jarðvísindadeild,,0,0,0
101,2007,Jarðvísindadeild,Grunnnám,0,0,0
102,2007,Jarðvísindadeild,Viðbótarnám,0,0,0
103,2007,Jarðvísindadeild,Meistarapróf,0,0,0
104,2007,Jarðvísindadeild,Doktorspróf,0,0,0
105,2007,Líf- og umhverfisvísindadeild,,0,0,0
106,2007,Líf- og umhverfisvísindadeild,Grunnnám,0,0,0
107,2007,Líf- og umhverfisvísindadeild,Viðbótarnám,0,0,0
108,2007,Líf- og umhverfisvísindadeild,Meistarapróf,0,0,0
109,2007,Líf- og umhverfisvísindadeild,Doktorspróf,0,0,0
110,2007,Rafmagns- og tölvuverkfræðideild,,0,0,0
111,2007,Rafmagns- og tölvuverkfræðideild,Grunnnám,0,0,0
112,2007,Rafmagns- og tölvuverkfræðideild,Viðbótarnám,0,0,0
113,2007,Rafmagns- og tölvuverkfræðideild,Meistarapróf,0,0,0
114,2007,Rafmagns- og tölvuverkfræðideild,Doktorspróf,0,0,0
115,2007,Raunvísindadeild,,0,0,0
116,2007,Raunvísindadeild,Grunnnám,0,0,0
117,2007,Raunvísindadeild,Viðbótarnám,0,0,0
118,2007,Raunvísindadeild,Meistarapróf,0,0,0
119,2007,Raunvísindadeild,Doktorspróf,0,0,0
120,2007,Umhverfis- og byggingaverkfræðideild,,43,12,55
121,2007,Umhverfis- og byggingaverkfræðideild,Grunnnám,0,0,0
122,2007,Umhverfis- og byggingaverkfræðideild,Viðbótarnám,0,0,0
123,2007,Umhverfis- og byggingaverkfræðideild,Meistarapróf,23,6,29
124,2007,Umhverfis- og byggingaverkfræðideild,Doktorspróf,20,6,26
125,2008,Félags- og mannvísindadeild,,177,858,1035
126,2008,Félags- og mannvísindadeild,Grunnnám,84,326,410
127,2008,Félags- og mannvísindadeild,Viðbótarnám,16,149,165
128,2008,Félags- og mannvísindadeild,Meistarapróf,54,299,353
129,2008,Félags- og mannvísindadeild,Doktorspróf,23,84,107
130,2008,Félagsráðgjafardeild,,29,265,294
131,2008,Félagsráðgjafardeild,Grunnnám,24,206,230
132,2008,Félagsráðgjafardeild,Viðbótarnám,3,19,22
133,2008,Félagsráðgjafardeild,Meistarapróf,2,38,40
134,2008,Félagsráðgjafardeild,Doktorspróf,0,2,2
135,2008,Hagfræðideild,,222,190,412
136,2008,Hagfræðideild,Grunnnám,143,98,241
137,2008,Hagfræðideild,Viðbótarnám,0,0,0
138,2008,Hagfræðideild,Meistarapróf,75,92,167
139,2008,Hagfræðideild,Doktorspróf,4,0,4
140,2008,Lagadeild,,351,404,755
141,2008,Lagadeild,Grunnnám,247,298,545
142,2008,Lagadeild,Viðbótarnám,0,0,0
143,2008,Lagadeild,Meistarapróf,102,104,206
144,2008,Lagadeild,Doktorspróf,2,2,4
145,2008,Stjórnmálafræðideild,,227,316,543
146,2008,Stjórnmálafræðideild,Grunnnám,121,117,238
147,2008,Stjórnmálafræðideild,Viðbótarnám,47,83,130
148,2008,Stjórnmálafræðideild,Meistarapróf,54,113,167
149,2008,Stjórnmálafræðideild,Doktorspróf,5,3,8
150,2008,Viðskiptafræðideild,,505,714,1219
151,2008,Viðskiptafræðideild,Grunnnám,279,312,591
152,2008,Viðskiptafræðideild,Viðbótarnám,26,56,82
153,2008,Viðskiptafræðideild,Meistarapróf,197,343,540
154,2008,Viðskiptafræðideild,Doktorspróf,3,3,6
155,2008,Hjúkrunarfræðideild,,15,523,538
156,2008,Hjúkrunarfræðideild,Grunnnám,11,334,345
157,2008,Hjúkrunarfræðideild,Viðbótarnám,2,129,131
158,2008,Hjúkrunarfræðideild,Meistarapróf,2,59,61
159,2008,Hjúkrunarfræðideild,Doktorspróf,0,1,1
160,2008,Lyfjafræðideild,,41,112,153
161,2008,Lyfjafræðideild,Grunnnám,28,74,102
162,2008,Lyfjafræðideild,Viðbótarnám,0,0,0
163,2008,Lyfjafræðideild,Meistarapróf,13,38,51
164,2008,Lyfjafræðideild,Doktorspróf,0,0,0
165,2008,Læknadeild,,184,346,530
166,2008,Læknadeild,Grunnnám,162,282,444
167,2008,Læknadeild,Viðbótarnám,0,11,11
168,2008,Læknadeild,Meistarapróf,12,30,42
169,2008,Læknadeild,Doktorspróf,10,23,33
170,2008,Matvæla- og næringarfræðideild,,12,65,77
171,2008,Matvæla- og næringarfræðideild,Grunnnám,8,47,55
172,2008,Matvæla- og næringarfræðideild,Viðbótarnám,0,1,1
173,2008,Matvæla- og næringarfræðideild,Meistarapróf,3,7,10
174,2008,Matvæla- og næringarfræðideild,Doktorspróf,1,10,11
175,2008,Sálfræðideild,,132,401,533
176,2008,Sálfræðideild,Grunnnám,117,352,469
177,2008,Sálfræðideild,Viðbótarnám,0,0,0
178,2008,Sálfræðideild,Meistarapróf,5,12,17
179,2008,Sálfræðideild,Doktorspróf,10,37,47
180,2008,Tannlæknadeild,,17,53,70
181,2008,Tannlæknadeild,Grunnnám,17,52,69
182,2008,Tannlæknadeild,Viðbótarnám,0,0,0
183,2008,Tannlæknadeild,Meistarapróf,0,1,1
184,2008,Tannlæknadeild,Doktorspróf,0,0,0
185,2008,"Deild erlendra tungumála, bókmennta og málvísinda",,173,482,655
186,2008,"Deild erlendra tungumála, bókmennta og málvísinda",Grunnnám,87,231,318
187,2008,"Deild erlendra tungumála, bókmennta og málvísinda",Viðbótarnám,16,71,87
188,2008,"Deild erlendra tungumála, bókmennta og málvísinda",Meistarapróf,14,82,96
189,2008,"Deild erlendra tungumála, bókmennta og málvísinda",Doktorspróf,56,98,154
190,2008,Guðfræði- og trúarbragðafræðideild,,34,67,101
191,2008,Guðfræði- og trúarbragðafræðideild,Grunnnám,28,36,64
192,2008,Guðfræði- og trúarbragðafræðideild,Viðbótarnám,3,24,27
193,2008,Guðfræði- og trúarbragðafræðideild,Meistarapróf,1,4,5
194,2008,Guðfræði- og trúarbragðafræðideild,Doktorspróf,2,3,5
195,2008,Íslensku- og menningardeild,,172,601,773
196,2008,Íslensku- og menningardeild,Grunnnám,139,459,598
197,2008,Íslensku- og menningardeild,Viðbótarnám,6,31,37
198,2008,Íslensku- og menningardeild,Meistarapróf,21,102,123
199,2008,Íslensku- og menningardeild,Doktorspróf,6,9,15
200,2008,Sagnfræði- og heimspekideild,,266,212,478
201,2008,Sagnfræði- og heimspekideild,Grunnnám,187,114,301
202,2008,Sagnfræði- og heimspekideild,Viðbótarnám,3,4,7
203,2008,Sagnfræði- og heimspekideild,Meistarapróf,46,71,117
204,2008,Sagnfræði- og heimspekideild,Doktorspróf,30,23,53
205,2008,"Íþrótta-, tómstunda- og þroskaþjálfadeild",,120,321,441
206,2008,"Íþrótta-, tómstunda- og þroskaþjálfadeild",Grunnnám,56,224,280
207,2008,"Íþrótta-, tómstunda- og þroskaþjálfadeild",Viðbótarnám,1,24,25
208,2008,"Íþrótta-, tómstunda- og þroskaþjálfadeild",Meistarapróf,63,73,136
209,2008,"Íþrótta-, tómstunda- og þroskaþjálfadeild",Doktorspróf,0,0,0
210,2008,Kennaradeild,,191,1297,1488
211,2008,Kennaradeild,Grunnnám,141,922,1063
212,2008,Kennaradeild,Viðbótarnám,28,146,174
213,2008,Kennaradeild,Meistarapróf,22,229,251
214,2008,Kennaradeild,Doktorspróf,0,0,0
215,2008,Uppeldis- og menntunarfræðideild,,35,243,278
216,2008,Uppeldis- og menntunarfræðideild,Grunnnám,29,218,247
217,2008,Uppeldis- og menntunarfræðideild,Viðbótarnám,4,15,19
218,2008,Uppeldis- og menntunarfræðideild,Meistarapróf,2,10,12
219,2008,Uppeldis- og menntunarfræðideild,Doktorspróf,0,0,0
220,2008,"Iðnaðarverkfræði-, vélaverkfræði- og tölvunarfræðideild",,402,185,587
221,2008,"Iðnaðarverkfræði-, vélaverkfræði- og tölvunarfræðideild",Grunnnám,304,122,426
222,2008,"Iðnaðarverkfræði-, vélaverkfræði- og tölvunarfræðideild",Viðbótarnám,0,0,0
223,2008,"Iðnaðarverkfræði-, vélaverkfræði- og tölvunarfræðideild",Meistarapróf,94,61,155
224,2008,"Iðnaðarverkfræði-, vélaverkfræði- og tölvunarfræðideild",Doktorspróf,4,2,6
225,2008,Jarðvísindadeild,,65,67,132
226,2008,Jarðvísindadeild,Grunnnám,43,53,96
227,2008,Jarðvísindadeild,Viðbótarnám,2,0,2
228,2008,Jarðvísindadeild,Meistarapróf,13,6,19
229,2008,Jarðvísindadeild,Doktorspróf,7,8,15
230,2008,Líf- og umhverfisvísindadeild,,131,251,382
231,2008,Líf- og umhverfisvísindadeild,Grunnnám,92,205,297
232,2008,Líf- og umhverfisvísindadeild,Viðbótarnám,2,2,4
233,2008,Líf- og umhverfisvísindadeild,Meistarapróf,20,22,42
234,2008,Líf- og umhverfisvísindadeild,Doktorspróf,17,22,39
235,2008,Rafmagns- og tölvuverkfræðideild,,89,15,104
236,2008,Rafmagns- og tölvuverkfræðideild,Grunnnám,82,13,95
237,2008,Rafmagns- og tölvuverkfræðideild,Viðbótarnám,0,0,0
238,2008,Rafmagns- og tölvuverkfræðideild,Meistarapróf,6,0,6
239,2008,Rafmagns- og tölvuverkfræðideild,Doktorspróf,1,2,3
240,2008,Raunvísindadeild,,173,95,268
241,2008,Raunvísindadeild,Grunnnám,125,77,202
242,2008,Raunvísindadeild,Viðbótarnám,0,0,0
243,2008,Raunvísindadeild,Meistarapróf,23,10,33
244,2008,Raunvísindadeild,Doktorspróf,25,8,33
245,2008,Umhverfis- og byggingaverkfræðideild,,131,69,202
246,2008,Umhverfis- og byggingaverkfræðideild,Grunnnám,107,56,163
247,2008,Umhverfis- og byggingaverkfræðideild,Viðbótarnám,0,0,35
248,2008,Umhverfis- og byggingaverkfræðideild,Meistarapróf,23,12,2
249,2008,Umhverfis- og byggingaverkfræðideild,Doktorspróf,1,1,2
250,2009,Félags- og mannvísindadeild,,215,967,1182
251,2009,Félags- og mannvísindadeild,Grunnnám,98,329,427
252,2009,Félags- og mannvísindadeild,Viðbótarnám,42,207,249
253,2009,Félags- og mannvísindadeild,Meistarapróf,46,285,331
254,2009,Félags- og mannvísindadeild,Doktorspróf,29,146,175
255,2009,Félagsráðgjafardeild,,33,306,339
256,2009,Félagsráðgjafardeild,Grunnnám,29,240,269
257,2009,Félagsráðgjafardeild,Viðbótarnám,3,21,24
258,2009,Félagsráðgjafardeild,Meistarapróf,1,42,43
259,2009,Félagsráðgjafardeild,Doktorspróf,0,3,3
260,2009,Hagfræðideild,,300,526,826
261,2009,Hagfræðideild,Grunnnám,155,308,463
262,2009,Hagfræðideild,Viðbótarnám,39,128,167
263,2009,Hagfræðideild,Meistarapróf,103,69,172
264,2009,Hagfræðideild,Doktorspróf,3,21,24
265,2009,Lagadeild,,341,399,740
266,2009,Lagadeild,Grunnnám,232,286,518
267,2009,Lagadeild,Viðbótarnám,0,0,0
268,2009,Lagadeild,Meistarapróf,106,111,217
269,2009,Lagadeild,Doktorspróf,3,2,5
270,2009,Stjórnmálafræðideild,,274,365,639
271,2009,Stjórnmálafræðideild,Grunnnám,150,140,290
272,2009,Stjórnmálafræðideild,Viðbótarnám,69,132,201
273,2009,Stjórnmálafræðideild,Meistarapróf,5,2,7
274,2009,Stjórnmálafræðideild,Doktorspróf,50,91,141
275,2009,Viðskiptafræðideild,,592,819,1411
276,2009,Viðskiptafræðideild,Grunnnám,326,395,721
277,2009,Viðskiptafræðideild,Viðbótarnám,0,0,0
278,2009,Viðskiptafræðideild,Meistarapróf,262,420,682
279,2009,Viðskiptafræðideild,Doktorspróf,4,4,8
280,2009,Hjúkrunarfræðideild,,15,521,536
281,2009,Hjúkrunarfræðideild,Grunnnám,11,328,339
282,2009,Hjúkrunarfræðideild,Viðbótarnám,2,106,108
283,2009,Hjúkrunarfræðideild,Meistarapróf,2,83,85
284,2009,Hjúkrunarfræðideild,Doktorspróf,0,4,4
285,2009,Lyfjafræðideild,,43,118,161
286,2009,Lyfjafræðideild,Grunnnám,26,72,98
287,2009,Lyfjafræðideild,Viðbótarnám,0,0,0
288,2009,Lyfjafræðideild,Meistarapróf,13,39,52
289,2009,Lyfjafræðideild,Doktorspróf,4,7,11
290,2009,Læknadeild,,95,100,195
291,2009,Læknadeild,Grunnnám,54,52,106
292,2009,Læknadeild,Viðbótarnám,0,0,0
293,2009,Læknadeild,Meistarapróf,30,41,71
294,2009,Læknadeild,Doktorspróf,11,7,18
295,2009,Matvæla- og næringarfræðideild,,16,74,90
296,2009,Matvæla- og næringarfræðideild,Grunnnám,9,55,64
297,2009,Matvæla- og næringarfræðideild,Viðbótarnám,3,8,11
298,2009,Matvæla- og næringarfræðideild,Meistarapróf,4,10,14
299,2009,Matvæla- og næringarfræðideild,Doktorspróf,0,1,1
300,2009,Sálfræðideild,,128,394,522
301,2009,Sálfræðideild,Grunnnám,112,343,455
302,2009,Sálfræðideild,Viðbótarnám,0,0,0
303,2009,Sálfræðideild,Meistarapróf,6,14,20
304,2009,Sálfræðideild,Doktorspróf,10,37,47
305,2009,Tannlæknadeild,,16,48,64
306,2009,Tannlæknadeild,Grunnnám,0,0,0
307,2009,Tannlæknadeild,Viðbótarnám,0,0,0
308,2009,Tannlæknadeild,Meistarapróf,16,48,64
309,2009,Tannlæknadeild,Doktorspróf,0,0,0
310,2009,"Deild erlendra tungumála, bókmennta og málvísinda",,205,544,749
311,2009,"Deild erlendra tungumála, bókmennta og málvísinda",Grunnnám,132,382,514
312,2009,"Deild erlendra tungumála, bókmennta og málvísinda",Viðbótarnám,0,0,0
313,2009,"Deild erlendra tungumála, bókmennta og málvísinda",Meistarapróf,8,59,67
314,2009,"Deild erlendra tungumála, bókmennta og málvísinda",Doktorspróf,65,103,168
315,2009,Guðfræði- og trúarbragðafræðideild,,40,72,112
316,2009,Guðfræði- og trúarbragðafræðideild,Grunnnám,12,23,35
317,2009,Guðfræði- og trúarbragðafræðideild,Viðbótarnám,0,7,7
318,2009,Guðfræði- og trúarbragðafræðideild,Meistarapróf,3,5,8
319,2009,Guðfræði- og trúarbragðafræðideild,Doktorspróf,25,37,62
320,2009,Íslensku- og menningardeild,,207,686,893
321,2009,Íslensku- og menningardeild,Grunnnám,166,540,706
322,2009,Íslensku- og menningardeild,Viðbótarnám,0,8,8
323,2009,Íslensku- og menningardeild,Meistarapróf,33,127,160
324,2009,Íslensku- og menningardeild,Doktorspróf,8,11,19
325,2009,Sagnfræði- og heimspekideild,,314,264,578
326,2009,Sagnfræði- og heimspekideild,Grunnnám,147,111,258
327,2009,Sagnfræði- og heimspekideild,Viðbótarnám,0,1,1
328,2009,Sagnfræði- og heimspekideild,Meistarapróf,31,57,88
329,2009,Sagnfræði- og heimspekideild,Doktorspróf,136,95,231
330,2009,"Íþrótta-, tómstunda- og þroskaþjálfadeild",,135,362,497
331,2009,"Íþrótta-, tómstunda- og þroskaþjálfadeild",Grunnnám,65,225,290
332,2009,"Íþrótta-, tómstunda- og þroskaþjálfadeild",Viðbótarnám,2,24,26
333,2009,"Íþrótta-, tómstunda- og þroskaþjálfadeild",Meistarapróf,68,113,181
334,2009,"Íþrótta-, tómstunda- og þroskaþjálfadeild",Doktorspróf,0,0,0
335,2009,Kennaradeild,,254,1444,1698
336,2009,Kennaradeild,Grunnnám,172,1064,1236
337,2009,Kennaradeild,Viðbótarnám,57,179,236
338,2009,Kennaradeild,Meistarapróf,25,201,226
339,2009,Kennaradeild,Doktorspróf,0,0,0
340,2009,Uppeldis- og menntunarfræðideild,,53,369,422
341,2009,Uppeldis- og menntunarfræðideild,Grunnnám,31,268,299
342,2009,Uppeldis- og menntunarfræðideild,Viðbótarnám,2,15,17
343,2009,Uppeldis- og menntunarfræðideild,Meistarapróf,15,65,80
344,2009,Uppeldis- og menntunarfræðideild,Doktorspróf,5,21,26
345,2009,"Iðnaðarverkfræði-, vélaverkfræði- og tölvunarfræðideild",,454,204,658
346,2009,"Iðnaðarverkfræði-, vélaverkfræði- og tölvunarfræðideild",Grunnnám,335,131,466
347,2009,"Iðnaðarverkfræði-, vélaverkfræði- og tölvunarfræðideild",Viðbótarnám,0,0,0
348,2009,"Iðnaðarverkfræði-, vélaverkfræði- og tölvunarfræðideild",Meistarapróf,115,69,184
349,2009,"Iðnaðarverkfræði-, vélaverkfræði- og tölvunarfræðideild",Doktorspróf,4,4,8
350,2009,Jarðvísindadeild,,79,91,170
351,2009,Jarðvísindadeild,Grunnnám,15,3,18
352,2009,Jarðvísindadeild,Viðbótarnám,12,7,19
353,2009,Jarðvísindadeild,Meistarapróf,11,9,20
354,2009,Jarðvísindadeild,Doktorspróf,41,72,113
355,2009,Líf- og umhverfisvísindadeild,,157,296,453
356,2009,Líf- og umhverfisvísindadeild,Grunnnám,114,242,356
357,2009,Líf- og umhverfisvísindadeild,Viðbótarnám,2,1,3
358,2009,Líf- og umhverfisvísindadeild,Meistarapróf,23,26,49
359,2009,Líf- og umhverfisvísindadeild,Doktorspróf,18,27,45
360,2009,Rafmagns- og tölvuverkfræðideild,,92,15,107
361,2009,Rafmagns- og tölvuverkfræðideild,Grunnnám,84,12,96
362,2009,Rafmagns- og tölvuverkfræðideild,Viðbótarnám,0,0,0
363,2009,Rafmagns- og tölvuverkfræðideild,Meistarapróf,6,0,6
364,2009,Rafmagns- og tölvuverkfræðideild,Doktorspróf,2,3,5
365,2009,Raunvísindadeild,,178,113,291
366,2009,Raunvísindadeild,Grunnnám,123,91,214
367,2009,Raunvísindadeild,Viðbótarnám,1,0,1
368,2009,Raunvísindadeild,Meistarapróf,26,13,39
369,2009,Raunvísindadeild,Doktorspróf,28,9,37
370,2009,Umhverfis- og byggingaverkfræðideild,,155,81,236
371,2009,Umhverfis- og byggingaverkfræðideild,Grunnnám,125,61,186
372,2009,Umhverfis- og byggingaverkfræðideild,Viðbótarnám,0,0,0
373,2009,Umhverfis- og byggingaverkfræðideild,Meistarapróf,29,18,47
374,2009,Umhverfis- og byggingaverkfræðideild,Doktorspróf,1,2,3
375,2010,Félags- og mannvísindadeild,,139,637,776
376,2010,Félags- og mannvísindadeild,Grunnnám,64,254,318
377,2010,Félags- og mannvísindadeild,Viðbótarnám,20,124,144
378,2010,Félags- og mannvísindadeild,Meistarapróf,43,235,278
379,2010,Félags- og mannvísindadeild,Doktorspróf,12,24,36
380,2010,Félagsráðgjafardeild,,23,251,274
381,2010,Félagsráðgjafardeild,Grunnnám,19,178,197
382,2010,Félagsráðgjafardeild,Viðbótarnám,2,19,21
383,2010,Félagsráðgjafardeild,Meistarapróf,2,51,53
384,2010,Félagsráðgjafardeild,Doktorspróf,0,3,3
385,2010,Hagfræðideild,,179,119,298
386,2010,Hagfræðideild,Grunnnám,100,66,166
387,2010,Hagfræðideild,Viðbótarnám,0,0,0
388,2010,Hagfræðideild,Meistarapróf,73,51,124
389,2010,Hagfræðideild,Doktorspróf,6,2,8
390,2010,Lagadeild,,232,277,509
391,2010,Lagadeild,Grunnnám,142,163,305
392,2010,Lagadeild,Viðbótarnám,0,0,0
393,2010,Lagadeild,Meistarapróf,87,112,199
394,2010,Lagadeild,Doktorspróf,3,2,5
395,2010,Stjórnmálafræðideild,,213,359,572
396,2010,Stjórnmálafræðideild,Grunnnám,86,82,168
397,2010,Stjórnmálafræðideild,Viðbótarnám,47,116,163
398,2010,Stjórnmálafræðideild,Meistarapróf,75,154,229
399,2010,Stjórnmálafræðideild,Doktorspróf,5,7,12
400,2010,Viðskiptafræðideild,,456,614,1070
401,2010,Viðskiptafræðideild,Grunnnám,198,231,429
402,2010,Viðskiptafræðideild,Viðbótarnám,0,0,0
403,2010,Viðskiptafræðideild,Meistarapróf,252,377,629
404,2010,Viðskiptafræðideild,Doktorspróf,6,6,12
405,2010,Hjúkrunarfræðideild,,11,383,394
406,2010,Hjúkrunarfræðideild,Grunnnám,8,230,238
407,2010,Hjúkrunarfræðideild,Viðbótarnám,1,51,52
408,2010,Hjúkrunarfræðideild,Meistarapróf,2,96,98
409,2010,Hjúkrunarfræðideild,Doktorspróf,0,6,6
410,2010,Lyfjafræðideild,,29,80,109
411,2010,Lyfjafræðideild,Grunnnám,15,33,48
412,2010,Lyfjafræðideild,Viðbótarnám,0,0,0
413,2010,Lyfjafræðideild,Meistarapróf,10,37,47
414,2010,Lyfjafræðideild,Doktorspróf,4,10,14
415,2010,Læknadeild,,164,317,481
416,2010,Læknadeild,Grunnnám,125,212,337
417,2010,Læknadeild,Viðbótarnám,0,19,19
418,2010,Læknadeild,Meistarapróf,21,58,79
419,2010,Læknadeild,Doktorspróf,18,28,46
420,2010,Matvæla- og næringarfræðideild,,15,52,67
421,2010,Matvæla- og næringarfræðideild,Grunnnám,6,31,37
422,2010,Matvæla- og næringarfræðideild,Viðbótarnám,0,0,0
423,2010,Matvæla- og næringarfræðideild,Meistarapróf,5,15,20
424,2010,Matvæla- og næringarfræðideild,Doktorspróf,4,6,10
425,2010,Sálfræðideild,,97,300,397
426,2010,Sálfræðideild,Grunnnám,77,231,308
427,2010,Sálfræðideild,Viðbótarnám,0,0,0
428,2010,Sálfræðideild,Meistarapróf,19,66,85
429,2010,Sálfræðideild,Doktorspróf,1,3,4
430,2010,Tannlæknadeild,,12,27,39
431,2010,Tannlæknadeild,Grunnnám,8,25,33
432,2010,Tannlæknadeild,Viðbótarnám,0,0,0
433,2010,Tannlæknadeild,Meistarapróf,3,2,5
434,2010,Tannlæknadeild,Doktorspróf,1,0,1
435,2010,"Deild erlendra tungumála, bókmennta og málvísinda",,124,360,484
436,2010,"Deild erlendra tungumála, bókmennta og málvísinda",Grunnnám,115,302,417
437,2010,"Deild erlendra tungumála, bókmennta og málvísinda",Viðbótarnám,0,0,0
438,2010,"Deild erlendra tungumála, bókmennta og málvísinda",Meistarapróf,9,53,62
439,2010,"Deild erlendra tungumála, bókmennta og málvísinda",Doktorspróf,0,5,5
440,2010,Guðfræði- og trúarbragðafræðideild,,33,57,90
441,2010,Guðfræði- og trúarbragðafræðideild,Grunnnám,25,42,67
442,2010,Guðfræði- og trúarbragðafræðideild,Viðbótarnám,0,7,7
443,2010,Guðfræði- og trúarbragðafræðideild,Meistarapróf,6,3,9
444,2010,Guðfræði- og trúarbragðafræðideild,Doktorspróf,2,5,7
445,2010,Íslensku- og menningardeild,,142,432,574
446,2010,Íslensku- og menningardeild,Grunnnám,90,290,380
447,2010,Íslensku- og menningardeild,Viðbótarnám,1,13,14
448,2010,Íslensku- og menningardeild,Meistarapróf,40,112,152
449,2010,Íslensku- og menningardeild,Doktorspróf,11,17,28
450,2010,Sagnfræði- og heimspekideild,,221,235,456
451,2010,Sagnfræði- og heimspekideild,Grunnnám,152,108,260
452,2010,Sagnfræði- og heimspekideild,Viðbótarnám,0,0,0
453,2010,Sagnfræði- og heimspekideild,Meistarapróf,55,113,168
454,2010,Sagnfræði- og heimspekideild,Doktorspróf,14,14,28
455,2010,"Íþrótta-, tómstunda- og þroskaþjálfadeild",,98,256,354
456,2010,"Íþrótta-, tómstunda- og þroskaþjálfadeild",Grunnnám,75,207,282
457,2010,"Íþrótta-, tómstunda- og þroskaþjálfadeild",Viðbótarnám,0,0,0
458,2010,"Íþrótta-, tómstunda- og þroskaþjálfadeild",Meistarapróf,23,49,72
459,2010,"Íþrótta-, tómstunda- og þroskaþjálfadeild",Doktorspróf,0,0,0
460,2010,Kennaradeild,,176,1007,1183
461,2010,Kennaradeild,Grunnnám,99,653,752
462,2010,Kennaradeild,Viðbótarnám,0,0,0
463,2010,Kennaradeild,Meistarapróf,44,122,166
464,2010,Kennaradeild,Doktorspróf,33,232,265
465,2010,Uppeldis- og menntunarfræðideild,,70,418,488
466,2010,Uppeldis- og menntunarfræðideild,Grunnnám,2,48,50
467,2010,Uppeldis- og menntunarfræðideild,Viðbótarnám,1,2,3
468,2010,Uppeldis- og menntunarfræðideild,Meistarapróf,65,358,423
469,2010,Uppeldis- og menntunarfræðideild,Doktorspróf,2,10,12
470,2010,"Iðnaðarverkfræði-, vélaverkfræði- og tölvunarfræðideild",,345,156,501
471,2010,"Iðnaðarverkfræði-, vélaverkfræði- og tölvunarfræðideild",Grunnnám,215,78,293
472,2010,"Iðnaðarverkfræði-, vélaverkfræði- og tölvunarfræðideild",Viðbótarnám,0,0,0
473,2010,"Iðnaðarverkfræði-, vélaverkfræði- og tölvunarfræðideild",Meistarapróf,123,74,197
474,2010,"Iðnaðarverkfræði-, vélaverkfræði- og tölvunarfræðideild",Doktorspróf,7,4,11
475,2010,Jarðvísindadeild,,50,57,126
476,2010,Jarðvísindadeild,Grunnnám,18,34,52
477,2010,Jarðvísindadeild,Viðbótarnám,0,0,36
478,2010,Jarðvísindadeild,Meistarapróf,21,15,19
479,2010,Jarðvísindadeild,Doktorspróf,11,8,19
480,2010,Líf- og umhverfisvísindadeild,,124,208,332
481,2010,Líf- og umhverfisvísindadeild,Grunnnám,83,145,228
482,2010,Líf- og umhverfisvísindadeild,Viðbótarnám,1,1,2
483,2010,Líf- og umhverfisvísindadeild,Meistarapróf,19,34,53
484,2010,Líf- og umhverfisvísindadeild,Doktorspróf,21,28,49
485,2010,Rafmagns- og tölvuverkfræðideild,,67,13,80
486,2010,Rafmagns- og tölvuverkfræðideild,Grunnnám,51,7,58
487,2010,Rafmagns- og tölvuverkfræðideild,Viðbótarnám,0,0,0
488,2010,Rafmagns- og tölvuverkfræðideild,Meistarapróf,11,2,13
489,2010,Rafmagns- og tölvuverkfræðideild,Doktorspróf,5,4,9
490,2010,Raunvísindadeild,,142,72,214
491,2010,Raunvísindadeild,Grunnnám,68,47,115
492,2010,Raunvísindadeild,Viðbótarnám,1,0,1
493,2010,Raunvísindadeild,Meistarapróf,39,15,54
494,2010,Raunvísindadeild,Doktorspróf,34,10,44
495,2010,Umhverfis- og byggingaverkfræðideild,,127,73,200
496,2010,Umhverfis- og byggingaverkfræðideild,Grunnnám,84,43,127
497,2010,Umhverfis- og byggingaverkfræðideild,Viðbótarnám,0,0,0
498,2010,Umhverfis- og byggingaverkfræðideild,Meistarapróf,40,23,63
499,2010,Umhverfis- og byggingaverkfræðideild,Doktorspróf,3,7,10
500,2011,Félags- og mannvísindadeild,,153,683,836
501,2011,Félags- og mannvísindadeild,Grunnnám,81,280,361
502,2011,Félags- og mannvísindadeild,Viðbótarnám,17,84,101
503,2011,Félags- og mannvísindadeild,Meistarapróf,39,282,321
504,2011,Félags- og mannvísindadeild,Doktorspróf,16,37,53
505,2011,Félagsráðgjafardeild,,24,291,315
506,2011,Félagsráðgjafardeild,Grunnnám,21,216,237
507,2011,Félagsráðgjafardeild,Viðbótarnám,0,8,8
508,2011,Félagsráðgjafardeild,Meistarapróf,3,63,66
509,2011,Félagsráðgjafardeild,Doktorspróf,0,4,4
510,2011,Hagfræðideild,,153,104,257
511,2011,Hagfræðideild,Grunnnám,98,62,160
512,2011,Hagfræðideild,Viðbótarnám,0,0,0
513,2011,Hagfræðideild,Meistarapróf,50,39,89
514,2011,Hagfræðideild,Doktorspróf,5,3,8
515,2011,Lagadeild,,235,265,500
516,2011,Lagadeild,Grunnnám,160,176,336
517,2011,Lagadeild,Viðbótarnám,0,0,0
518,2011,Lagadeild,Meistarapróf,72,87,159
519,2011,Lagadeild,Doktorspróf,3,2,5
520,2011,Stjórnmálafræðideild,,221,393,614
521,2011,Stjórnmálafræðideild,Grunnnám,96,87,183
522,2011,Stjórnmálafræðideild,Viðbótarnám,56,134,190
523,2011,Stjórnmálafræðideild,Meistarapróf,65,162,227
524,2011,Stjórnmálafræðideild,Doktorspróf,4,10,14
525,2011,Viðskiptafræðideild,,447,543,990
526,2011,Viðskiptafræðideild,Grunnnám,209,230,439
527,2011,Viðskiptafræðideild,Viðbótarnám,0,0,0
528,2011,Viðskiptafræðideild,Meistarapróf,233,305,538
529,2011,Viðskiptafræðideild,Doktorspróf,5,8,13
530,2011,Hjúkrunarfræðideild,,8,350,358
531,2011,Hjúkrunarfræðideild,Grunnnám,5,222,227
532,2011,Hjúkrunarfræðideild,Viðbótarnám,2,37,39
533,2011,Hjúkrunarfræðideild,Meistarapróf,1,82,83
534,2011,Hjúkrunarfræðideild,Doktorspróf,0,9,9
535,2011,Lyfjafræðideild,,23,80,103
536,2011,Lyfjafræðideild,Grunnnám,9,33,42
537,2011,Lyfjafræðideild,Viðbótarnám,0,0,0
538,2011,Lyfjafræðideild,Meistarapróf,11,35,46
539,2011,Lyfjafræðideild,Doktorspróf,3,12,15
540,2011,Læknadeild,,162,306,468
541,2011,Læknadeild,Grunnnám,123,206,329
542,2011,Læknadeild,Viðbótarnám,1,13,14
543,2011,Læknadeild,Meistarapróf,20,58,78
544,2011,Læknadeild,Doktorspróf,18,29,47
545,2011,Matvæla- og næringarfræðideild,,12,54,66
546,2011,Matvæla- og næringarfræðideild,Grunnnám,4,33,37
547,2011,Matvæla- og næringarfræðideild,Viðbótarnám,0,0,0
548,2011,Matvæla- og næringarfræðideild,Meistarapróf,6,12,18
549,2011,Matvæla- og næringarfræðideild,Doktorspróf,2,9,11
550,2011,Sálfræðideild,,117,295,412
551,2011,Sálfræðideild,Grunnnám,96,221,317
552,2011,Sálfræðideild,Viðbótarnám,0,0,0
553,2011,Sálfræðideild,Meistarapróf,19,69,88
554,2011,Sálfræðideild,Doktorspróf,2,5,7
555,2011,Tannlæknadeild,,11,33,44
556,2011,Tannlæknadeild,Grunnnám,8,31,39
557,2011,Tannlæknadeild,Viðbótarnám,0,0,0
558,2011,Tannlæknadeild,Meistarapróf,2,2,4
559,2011,Tannlæknadeild,Doktorspróf,1,0,1
560,2011,"Deild erlendra tungumála, bókmennta og málvísinda",,137,335,472
561,2011,"Deild erlendra tungumála, bókmennta og málvísinda",Grunnnám,124,279,403
562,2011,"Deild erlendra tungumála, bókmennta og málvísinda",Viðbótarnám,0,0,0
563,2011,"Deild erlendra tungumála, bókmennta og málvísinda",Meistarapróf,13,52,65
564,2011,"Deild erlendra tungumála, bókmennta og málvísinda",Doktorspróf,0,4,4
565,2011,Guðfræði- og trúarbragðafræðideild,,36,61,97
566,2011,Guðfræði- og trúarbragðafræðideild,Grunnnám,25,48,73
567,2011,Guðfræði- og trúarbragðafræðideild,Viðbótarnám,0,4,4
568,2011,Guðfræði- og trúarbragðafræðideild,Meistarapróf,10,3,13
569,2011,Guðfræði- og trúarbragðafræðideild,Doktorspróf,1,6,7
570,2011,Íslensku- og menningardeild,,171,501,672
571,2011,Íslensku- og menningardeild,Grunnnám,108,318,426
572,2011,Íslensku- og menningardeild,Viðbótarnám,0,13,13
573,2011,Íslensku- og menningardeild,Meistarapróf,52,151,203
574,2011,Íslensku- og menningardeild,Doktorspróf,11,19,30
575,2011,Sagnfræði- og heimspekideild,,246,234,480
576,2011,Sagnfræði- og heimspekideild,Grunnnám,168,102,270
577,2011,Sagnfræði- og heimspekideild,Viðbótarnám,3,5,8
578,2011,Sagnfræði- og heimspekideild,Meistarapróf,54,113,167
579,2011,Sagnfræði- og heimspekideild,Doktorspróf,21,14,35
580,2011,"Íþrótta-, tómstunda- og þroskaþjálfadeild",,88,244,332
581,2011,"Íþrótta-, tómstunda- og þroskaþjálfadeild",Grunnnám,73,189,262
582,2011,"Íþrótta-, tómstunda- og þroskaþjálfadeild",Viðbótarnám,0,0,0
583,2011,"Íþrótta-, tómstunda- og þroskaþjálfadeild",Meistarapróf,15,55,70
584,2011,"Íþrótta-, tómstunda- og þroskaþjálfadeild",Doktorspróf,0,0,0
585,2011,Kennaradeild,,171,838,1009
586,2011,Kennaradeild,Grunnnám,94,516,610
587,2011,Kennaradeild,Viðbótarnám,0,0,0
588,2011,Kennaradeild,Meistarapróf,48,122,170
589,2011,Kennaradeild,Doktorspróf,29,200,229
590,2011,Uppeldis- og menntunarfræðideild,,75,435,510
591,2011,Uppeldis- og menntunarfræðideild,Grunnnám,70,357,427
592,2011,Uppeldis- og menntunarfræðideild,Viðbótarnám,0,0,0
593,2011,Uppeldis- og menntunarfræðideild,Meistarapróf,3,69,72
594,2011,Uppeldis- og menntunarfræðideild,Doktorspróf,2,9,11
595,2011,"Iðnaðarverkfræði-, vélaverkfræði- og tölvunarfræðideild",,380,154,534
596,2011,"Iðnaðarverkfræði-, vélaverkfræði- og tölvunarfræðideild",Grunnnám,241,79,320
597,2011,"Iðnaðarverkfræði-, vélaverkfræði- og tölvunarfræðideild",Viðbótarnám,0,0,0
598,2011,"Iðnaðarverkfræði-, vélaverkfræði- og tölvunarfræðideild",Meistarapróf,130,70,200
599,2011,"Iðnaðarverkfræði-, vélaverkfræði- og tölvunarfræðideild",Doktorspróf,9,5,14
600,2011,Jarðvísindadeild,,53,62,115
601,2011,Jarðvísindadeild,Grunnnám,26,32,58
602,2011,Jarðvísindadeild,Viðbótarnám,0,0,0
603,2011,Jarðvísindadeild,Meistarapróf,15,21,36
604,2011,Jarðvísindadeild,Doktorspróf,12,9,21
605,2011,Líf- og umhverfisvísindadeild,,147,202,349
606,2011,Líf- og umhverfisvísindadeild,Grunnnám,101,148,249
607,2011,Líf- og umhverfisvísindadeild,Viðbótarnám,3,0,3
608,2011,Líf- og umhverfisvísindadeild,Meistarapróf,15,26,41
609,2011,Líf- og umhverfisvísindadeild,Doktorspróf,28,28,56
610,2011,Rafmagns- og tölvuverkfræðideild,,34,32,66
611,2011,Rafmagns- og tölvuverkfræðideild,Grunnnám,15,21,36
612,2011,Rafmagns- og tölvuverkfræðideild,Viðbótarnám,0,0,0
613,2011,Rafmagns- og tölvuverkfræðideild,Meistarapróf,12,9,21
614,2011,Rafmagns- og tölvuverkfræðideild,Doktorspróf,7,2,9
615,2011,Raunvísindadeild,,136,64,200
616,2011,Raunvísindadeild,Grunnnám,74,47,121
617,2011,Raunvísindadeild,Viðbótarnám,0,0,0
618,2011,Raunvísindadeild,Meistarapróf,32,7,39
619,2011,Raunvísindadeild,Doktorspróf,30,10,40
620,2011,Umhverfis- og byggingaverkfræðideild,,114,68,182
621,2011,Umhverfis- og byggingaverkfræðideild,Grunnnám,80,38,118
622,2011,Umhverfis- og byggingaverkfræðideild,Viðbótarnám,0,0,0
623,2011,Umhverfis- og byggingaverkfræðideild,Meistarapróf,31,20,51
624,2011,Umhverfis- og byggingaverkfræðideild,Doktorspróf,3,10,13
625,2012,Félags- og mannvísindadeild,,100,623,723
626,2012,Félags- og mannvísindadeild,Grunnnám,30,230,260
627,2012,Félags- og mannvísindadeild,Viðbótarnám,17,87,104
628,2012,Félags- og mannvísindadeild,Meistarapróf,41,269,310
629,2012,Félags- og mannvísindadeild,Doktorspróf,12,37,49
630,2012,Félagsráðgjafardeild,,31,337,368
631,2012,Félagsráðgjafardeild,Grunnnám,25,246,271
632,2012,Félagsráðgjafardeild,Viðbótarnám,0,5,5
633,2012,Félagsráðgjafardeild,Meistarapróf,6,82,88
634,2012,Félagsráðgjafardeild,Doktorspróf,0,4,4
635,2012,Hagfræðideild,,146,83,229
636,2012,Hagfræðideild,Grunnnám,94,51,145
637,2012,Hagfræðideild,Viðbótarnám,0,0,0
638,2012,Hagfræðideild,Meistarapróf,48,30,78
639,2012,Hagfræðideild,Doktorspróf,4,2,6
640,2012,Lagadeild,,257,281,538
641,2012,Lagadeild,Grunnnám,171,187,358
642,2012,Lagadeild,Viðbótarnám,0,0,0
643,2012,Lagadeild,Meistarapróf,82,90,172
644,2012,Lagadeild,Doktorspróf,4,4,8
645,2012,Stjórnmálafræðideild,,212,361,573
646,2012,Stjórnmálafræðideild,Grunnnám,90,66,156
647,2012,Stjórnmálafræðideild,Viðbótarnám,63,130,193
648,2012,Stjórnmálafræðideild,Meistarapróf,56,155,211
649,2012,Stjórnmálafræðideild,Doktorspróf,3,10,13
650,2012,Viðskiptafræðideild,,479,572,1051
651,2012,Viðskiptafræðideild,Grunnnám,221,229,450
652,2012,Viðskiptafræðideild,Viðbótarnám,0,0,0
653,2012,Viðskiptafræðideild,Meistarapróf,254,337,591
654,2012,Viðskiptafræðideild,Doktorspróf,4,6,10
655,2012,Hjúkrunarfræðideild,,5,375,380
656,2012,Hjúkrunarfræðideild,Grunnnám,4,257,261
657,2012,Hjúkrunarfræðideild,Viðbótarnám,1,39,40
658,2012,Hjúkrunarfræðideild,Meistarapróf,0,69,69
659,2012,Hjúkrunarfræðideild,Doktorspróf,0,10,10
660,2012,Lyfjafræðideild,,20,78,98
661,2012,Lyfjafræðideild,Grunnnám,8,35,43
662,2012,Lyfjafræðideild,Viðbótarnám,0,0,0
663,2012,Lyfjafræðideild,Meistarapróf,10,31,41
664,2012,Lyfjafræðideild,Doktorspróf,2,12,14
665,2012,Læknadeild,,165,300,465
666,2012,Læknadeild,Grunnnám,133,212,345
667,2012,Læknadeild,Viðbótarnám,1,11,12
668,2012,Læknadeild,Meistarapróf,19,52,71
669,2012,Læknadeild,Doktorspróf,12,25,37
670,2012,Matvæla- og næringarfræðideild,,10,54,64
671,2012,Matvæla- og næringarfræðideild,Grunnnám,7,33,40
672,2012,Matvæla- og næringarfræðideild,Viðbótarnám,0,0,0
673,2012,Matvæla- og næringarfræðideild,Meistarapróf,2,11,13
674,2012,Matvæla- og næringarfræðideild,Doktorspróf,1,10,11
675,2012,Sálfræðideild,,122,318,440
676,2012,Sálfræðideild,Grunnnám,101,247,348
677,2012,Sálfræðideild,Viðbótarnám,0,0,0
678,2012,Sálfræðideild,Meistarapróf,7,28,35
679,2012,Sálfræðideild,Doktorspróf,14,43,57
680,2012,Tannlæknadeild,,15,41,56
681,2012,Tannlæknadeild,Grunnnám,13,39,52
682,2012,Tannlæknadeild,Viðbótarnám,0,0,0
683,2012,Tannlæknadeild,Meistarapróf,2,2,4
684,2012,Tannlæknadeild,Doktorspróf,0,0,0
685,2012,"Deild erlendra tungumála, bókmennta og málvísinda",,166,377,543
686,2012,"Deild erlendra tungumála, bókmennta og málvísinda",Grunnnám,146,306,452
687,2012,"Deild erlendra tungumála, bókmennta og málvísinda",Viðbótarnám,0,0,0
688,2012,"Deild erlendra tungumála, bókmennta og málvísinda",Meistarapróf,20,66,86
689,2012,"Deild erlendra tungumála, bókmennta og málvísinda",Doktorspróf,0,5,5
690,2012,Guðfræði- og trúarbragðafræðideild,,29,63,92
691,2012,Guðfræði- og trúarbragðafræðideild,Grunnnám,16,39,55
692,2012,Guðfræði- og trúarbragðafræðideild,Viðbótarnám,0,4,4
693,2012,Guðfræði- og trúarbragðafræðideild,Meistarapróf,11,11,22
694,2012,Guðfræði- og trúarbragðafræðideild,Doktorspróf,2,9,11
695,2012,Íslensku- og menningardeild,,201,543,744
696,2012,Íslensku- og menningardeild,Grunnnám,118,335,453
697,2012,Íslensku- og menningardeild,Viðbótarnám,0,10,10
698,2012,Íslensku- og menningardeild,Meistarapróf,71,176,247
699,2012,Íslensku- og menningardeild,Doktorspróf,12,22,34
700,2012,Sagnfræði- og heimspekideild,,267,253,520
701,2012,Sagnfræði- og heimspekideild,Grunnnám,193,122,315
702,2012,Sagnfræði- og heimspekideild,Viðbótarnám,2,10,12
703,2012,Sagnfræði- og heimspekideild,Meistarapróf,50,106,156
704,2012,Sagnfræði- og heimspekideild,Doktorspróf,22,15,37
705,2012,"Íþrótta-, tómstunda- og þroskaþjálfadeild",,85,238,323
706,2012,"Íþrótta-, tómstunda- og þroskaþjálfadeild",Grunnnám,56,184,240
707,2012,"Íþrótta-, tómstunda- og þroskaþjálfadeild",Viðbótarnám,0,0,0
708,2012,"Íþrótta-, tómstunda- og þroskaþjálfadeild",Meistarapróf,29,54,83
709,2012,"Íþrótta-, tómstunda- og þroskaþjálfadeild",Doktorspróf,0,0,0
710,2012,Kennaradeild,,126,664,790
711,2012,Kennaradeild,Grunnnám,77,384,461
712,2012,Kennaradeild,Viðbótarnám,0,0,0
713,2012,Kennaradeild,Meistarapróf,19,73,92
714,2012,Kennaradeild,Doktorspróf,30,207,237
715,2012,Uppeldis- og menntunarfræðideild,,71,471,542
716,2012,Uppeldis- og menntunarfræðideild,Grunnnám,56,365,421
717,2012,Uppeldis- og menntunarfræðideild,Viðbótarnám,0,0,0
718,2012,Uppeldis- og menntunarfræðideild,Meistarapróf,9,93,102
719,2012,Uppeldis- og menntunarfræðideild,Doktorspróf,6,13,19
720,2012,"Iðnaðarverkfræði-, vélaverkfræði- og tölvunarfræðideild",,327,133,460
721,2012,"Iðnaðarverkfræði-, vélaverkfræði- og tölvunarfræðideild",Grunnnám,236,90,326
722,2012,"Iðnaðarverkfræði-, vélaverkfræði- og tölvunarfræðideild",Viðbótarnám,0,0,0
723,2012,"Iðnaðarverkfræði-, vélaverkfræði- og tölvunarfræðideild",Meistarapróf,86,35,121
724,2012,"Iðnaðarverkfræði-, vélaverkfræði- og tölvunarfræðideild",Doktorspróf,5,8,13
725,2012,Jarðvísindadeild,,78,75,153
726,2012,Jarðvísindadeild,Grunnnám,51,48,99
727,2012,Jarðvísindadeild,Viðbótarnám,0,0,0
728,2012,Jarðvísindadeild,Meistarapróf,14,17,31
729,2012,Jarðvísindadeild,Doktorspróf,13,10,23
730,2012,Líf- og umhverfisvísindadeild,,144,215,359
731,2012,Líf- og umhverfisvísindadeild,Grunnnám,102,153,255
732,2012,Líf- og umhverfisvísindadeild,Viðbótarnám,1,2,3
733,2012,Líf- og umhverfisvísindadeild,Meistarapróf,14,28,42
734,2012,Líf- og umhverfisvísindadeild,Doktorspróf,27,32,59
735,2012,Rafmagns- og tölvuverkfræðideild,,55,9,64
736,2012,Rafmagns- og tölvuverkfræðideild,Grunnnám,46,6,52
737,2012,Rafmagns- og tölvuverkfræðideild,Viðbótarnám,0,0,0
738,2012,Rafmagns- og tölvuverkfræðideild,Meistarapróf,5,2,7
739,2012,Rafmagns- og tölvuverkfræðideild,Doktorspróf,4,1,5
740,2012,Raunvísindadeild,,133,63,196
741,2012,Raunvísindadeild,Grunnnám,90,48,138
742,2012,Raunvísindadeild,Viðbótarnám,0,1,1
743,2012,Raunvísindadeild,Meistarapróf,18,7,25
744,2012,Raunvísindadeild,Doktorspróf,25,7,32
745,2012,Umhverfis- og byggingaverkfræðideild,,97,61,158
746,2012,Umhverfis- og byggingaverkfræðideild,Grunnnám,67,32,99
747,2012,Umhverfis- og byggingaverkfræðideild,Viðbótarnám,0,0,0
748,2012,Umhverfis- og byggingaverkfræðideild,Meistarapróf,27,21,48
749,2012,Umhverfis- og byggingaverkfræðideild,Doktorspróf,3,8,11
750,2013,Félags- og mannvísindadeild,,168,741,909
751,2013,Félags- og mannvísindadeild,Grunnnám,98,339,437
752,2013,Félags- og mannvísindadeild,Viðbótarnám,16,103,119
753,2013,Félags- og mannvísindadeild,Meistarapróf,42,260,302
754,2013,Félags- og mannvísindadeild,Doktorspróf,12,39,51
755,2013,Félagsráðgjafardeild,,34,355,389
756,2013,Félagsráðgjafardeild,Grunnnám,27,259,286
757,2013,Félagsráðgjafardeild,Viðbótarnám,0,9,9
758,2013,Félagsráðgjafardeild,Meistarapróf,7,83,90
759,2013,Félagsráðgjafardeild,Doktorspróf,0,4,4
760,2013,Hagfræðideild,,166,127,293
761,2013,Hagfræðideild,Grunnnám,121,99,220
762,2013,Hagfræðideild,Viðbótarnám,4,6,10
763,2013,Hagfræðideild,Meistarapróf,37,20,57
764,2013,Hagfræðideild,Doktorspróf,4,2,6
765,2013,Lagadeild,,248,303,551
766,2013,Lagadeild,Grunnnám,155,185,340
767,2013,Lagadeild,Viðbótarnám,0,0,0
768,2013,Lagadeild,Meistarapróf,89,113,202
769,2013,Lagadeild,Doktorspróf,4,5,9
770,2013,Stjórnmálafræðideild,,194,332,526
771,2013,Stjórnmálafræðideild,Grunnnám,80,67,147
772,2013,Stjórnmálafræðideild,Viðbótarnám,63,122,185
773,2013,Stjórnmálafræðideild,Meistarapróf,50,136,186
774,2013,Stjórnmálafræðideild,Doktorspróf,1,7,8
775,2013,Viðskiptafræðideild,,506,597,1103
776,2013,Viðskiptafræðideild,Grunnnám,273,276,549
777,2013,Viðskiptafræðideild,Viðbótarnám,0,0,0
778,2013,Viðskiptafræðideild,Meistarapróf,228,313,541
779,2013,Viðskiptafræðideild,Doktorspróf,5,8,13
780,2013,Hjúkrunarfræðideild,,6,345,351
781,2013,Hjúkrunarfræðideild,Grunnnám,3,261,264
782,2013,Hjúkrunarfræðideild,Viðbótarnám,0,20,20
783,2013,Hjúkrunarfræðideild,Meistarapróf,3,53,56
784,2013,Hjúkrunarfræðideild,Doktorspróf,0,11,11
785,2013,Lyfjafræðideild,,20,74,94
786,2013,Lyfjafræðideild,Grunnnám,9,36,45
787,2013,Lyfjafræðideild,Viðbótarnám,0,0,0
788,2013,Lyfjafræðideild,Meistarapróf,8,28,36
789,2013,Lyfjafræðideild,Doktorspróf,3,10,13
790,2013,Læknadeild,,172,322,494
791,2013,Læknadeild,Grunnnám,77,147,224
792,2013,Læknadeild,Viðbótarnám,0,13,13
793,2013,Læknadeild,Meistarapróf,21,47,68
794,2013,Læknadeild,Doktorspróf,74,115,189
795,2013,Matvæla- og næringarfræðideild,,11,68,79
796,2013,Matvæla- og næringarfræðideild,Grunnnám,7,29,36
797,2013,Matvæla- og næringarfræðideild,Viðbótarnám,0,0,0
798,2013,Matvæla- og næringarfræðideild,Meistarapróf,1,30,31
799,2013,Matvæla- og næringarfræðideild,Doktorspróf,3,9,12
800,2013,Sálfræðideild,,116,287,403
801,2013,Sálfræðideild,Grunnnám,99,226,325
802,2013,Sálfræðideild,Viðbótarnám,0,0,0
803,2013,Sálfræðideild,Meistarapróf,7,16,23
804,2013,Sálfræðideild,Doktorspróf,10,45,55
805,2013,Tannlæknadeild,,13,41,54
806,2013,Tannlæknadeild,Grunnnám,12,41,53
807,2013,Tannlæknadeild,Viðbótarnám,0,0,0
808,2013,Tannlæknadeild,Meistarapróf,1,0,1
809,2013,Tannlæknadeild,Doktorspróf,0,0,0
810,2013,"Deild erlendra tungumála, bókmennta og málvísinda",,172,398,570
811,2013,"Deild erlendra tungumála, bókmennta og málvísinda",Grunnnám,152,321,473
812,2013,"Deild erlendra tungumála, bókmennta og málvísinda",Viðbótarnám,0,0,0
813,2013,"Deild erlendra tungumála, bókmennta og málvísinda",Meistarapróf,17,72,89
814,2013,"Deild erlendra tungumála, bókmennta og málvísinda",Doktorspróf,3,5,8
815,2013,Guðfræði- og trúarbragðafræðideild,,39,52,91
816,2013,Guðfræði- og trúarbragðafræðideild,Grunnnám,20,27,47
817,2013,Guðfræði- og trúarbragðafræðideild,Viðbótarnám,0,6,6
818,2013,Guðfræði- og trúarbragðafræðideild,Meistarapróf,15,14,29
819,2013,Guðfræði- og trúarbragðafræðideild,Doktorspróf,4,5,9
820,2013,Íslensku- og menningardeild,,206,565,771
821,2013,Íslensku- og menningardeild,Grunnnám,124,344,468
822,2013,Íslensku- og menningardeild,Viðbótarnám,0,9,9
823,2013,Íslensku- og menningardeild,Meistarapróf,65,187,252
824,2013,Íslensku- og menningardeild,Doktorspróf,17,25,42
825,2013,Sagnfræði- og heimspekideild,,252,229,481
826,2013,Sagnfræði- og heimspekideild,Grunnnám,173,99,272
827,2013,Sagnfræði- og heimspekideild,Viðbótarnám,5,11,16
828,2013,Sagnfræði- og heimspekideild,Meistarapróf,53,98,151
829,2013,Sagnfræði- og heimspekideild,Doktorspróf,21,21,42
830,2013,"Íþrótta-, tómstunda- og þroskaþjálfadeild",,101,258,359
831,2013,"Íþrótta-, tómstunda- og þroskaþjálfadeild",Grunnnám,69,182,251
832,2013,"Íþrótta-, tómstunda- og þroskaþjálfadeild",Viðbótarnám,0,0,0
833,2013,"Íþrótta-, tómstunda- og þroskaþjálfadeild",Meistarapróf,3,18,21
834,2013,"Íþrótta-, tómstunda- og þroskaþjálfadeild",Doktorspróf,29,58,87
835,2013,Kennaradeild,,141,675,816
836,2013,Kennaradeild,Grunnnám,67,327,394
837,2013,Kennaradeild,Viðbótarnám,0,0,0
838,2013,Kennaradeild,Meistarapróf,36,99,135
839,2013,Kennaradeild,Doktorspróf,38,249,287
840,2013,Uppeldis- og menntunarfræðideild,,78,467,545
841,2013,Uppeldis- og menntunarfræðideild,Grunnnám,11,96,107
842,2013,Uppeldis- og menntunarfræðideild,Viðbótarnám,0,0,0
843,2013,Uppeldis- og menntunarfræðideild,Meistarapróf,62,364,426
844,2013,Uppeldis- og menntunarfræðideild,Doktorspróf,5,7,12
845,2013,"Iðnaðarverkfræði-, vélaverkfræði- og tölvunarfræðideild",,361,129,490
846,2013,"Iðnaðarverkfræði-, vélaverkfræði- og tölvunarfræðideild",Grunnnám,266,96,362
847,2013,"Iðnaðarverkfræði-, vélaverkfræði- og tölvunarfræðideild",Viðbótarnám,0,0,0
848,2013,"Iðnaðarverkfræði-, vélaverkfræði- og tölvunarfræðideild",Meistarapróf,89,28,117
849,2013,"Iðnaðarverkfræði-, vélaverkfræði- og tölvunarfræðideild",Doktorspróf,6,5,11
850,2013,Jarðvísindadeild,,114,120,234
851,2013,Jarðvísindadeild,Grunnnám,70,75,145
852,2013,Jarðvísindadeild,Viðbótarnám,0,0,0
853,2013,Jarðvísindadeild,Meistarapróf,30,34,64
854,2013,Jarðvísindadeild,Doktorspróf,14,11,25
855,2013,Líf- og umhverfisvísindadeild,,156,221,377
856,2013,Líf- og umhverfisvísindadeild,Grunnnám,86,133,219
857,2013,Líf- og umhverfisvísindadeild,Viðbótarnám,0,0,0
858,2013,Líf- og umhverfisvísindadeild,Meistarapróf,44,61,105
859,2013,Líf- og umhverfisvísindadeild,Doktorspróf,26,27,53
860,2013,Rafmagns- og tölvuverkfræðideild,,63,8,71
861,2013,Rafmagns- og tölvuverkfræðideild,Grunnnám,46,6,52
862,2013,Rafmagns- og tölvuverkfræðideild,Viðbótarnám,0,0,0
863,2013,Rafmagns- og tölvuverkfræðideild,Meistarapróf,12,2,14
864,2013,Rafmagns- og tölvuverkfræðideild,Doktorspróf,5,0,5
865,2013,Raunvísindadeild,,156,83,239
866,2013,Raunvísindadeild,Grunnnám,97,63,160
867,2013,Raunvísindadeild,Viðbótarnám,0,0,0
868,2013,Raunvísindadeild,Meistarapróf,37,13,50
869,2013,Raunvísindadeild,Doktorspróf,22,7,29
870,2013,Umhverfis- og byggingaverkfræðideild,,81,62,143
871,2013,Umhverfis- og byggingaverkfræðideild,Grunnnám,48,30,78
872,2013,Umhverfis- og byggingaverkfræðideild,Viðbótarnám,0,0,0
873,2013,Umhverfis- og byggingaverkfræðideild,Meistarapróf,31,26,57
874,2013,Umhverfis- og byggingaverkfræðideild,Doktorspróf,2,6,8
875,2014,Félags- og mannvísindadeild,,173,761,934
876,2014,Félags- og mannvísindadeild,Grunnnám,94,302,396
877,2014,Félags- og mannvísindadeild,Viðbótarnám,21,105,126
878,2014,Félags- og mannvísindadeild,Meistarapróf,47,315,362
879,2014,Félags- og mannvísindadeild,Doktorspróf,11,39,50
880,2014,Félagsráðgjafardeild,,29,328,357
881,2014,Félagsráðgjafardeild,Grunnnám,18,216,234
882,2014,Félagsráðgjafardeild,Viðbótarnám,0,0,0
883,2014,Félagsráðgjafardeild,Meistarapróf,0,7,7
884,2014,Félagsráðgjafardeild,Doktorspróf,11,105,116
885,2014,Hagfræðideild,,128,71,199
886,2014,Hagfræðideild,Grunnnám,66,29,95
887,2014,Hagfræðideild,Viðbótarnám,18,19,37
888,2014,Hagfræðideild,Meistarapróf,39,21,60
889,2014,Hagfræðideild,Doktorspróf,5,2,7
890,2014,Lagadeild,,254,300,554
891,2014,Lagadeild,Grunnnám,155,175,330
892,2014,Lagadeild,Viðbótarnám,0,0,0
893,2014,Lagadeild,Meistarapróf,96,121,217
894,2014,Lagadeild,Doktorspróf,3,4,7
895,2014,Stjórnmálafræðideild,,204,407,611
896,2014,Stjórnmálafræðideild,Grunnnám,74,53,127
897,2014,Stjórnmálafræðideild,Viðbótarnám,67,192,259
898,2014,Stjórnmálafræðideild,Meistarapróf,62,155,217
899,2014,Stjórnmálafræðideild,Doktorspróf,1,7,8
900,2014,Viðskiptafræðideild,,492,613,1105
901,2014,Viðskiptafræðideild,Grunnnám,258,253,511
902,2014,Viðskiptafræðideild,Viðbótarnám,0,0,0
903,2014,Viðskiptafræðideild,Meistarapróf,231,355,586
904,2014,Viðskiptafræðideild,Doktorspróf,3,5,8
905,2014,Hjúkrunarfræðideild,,7,410,417
906,2014,Hjúkrunarfræðideild,Grunnnám,3,238,241
907,2014,Hjúkrunarfræðideild,Viðbótarnám,2,59,61
908,2014,Hjúkrunarfræðideild,Meistarapróf,2,102,104
909,2014,Hjúkrunarfræðideild,Doktorspróf,0,11,11
910,2014,Lyfjafræðideild,,24,96,120
911,2014,Lyfjafræðideild,Grunnnám,15,47,62
912,2014,Lyfjafræðideild,Viðbótarnám,0,0,0
913,2014,Lyfjafræðideild,Meistarapróf,6,38,44
914,2014,Lyfjafræðideild,Doktorspróf,3,11,14
915,2014,Læknadeild,,198,365,563
916,2014,Læknadeild,Grunnnám,74,146,220
917,2014,Læknadeild,Viðbótarnám,66,95,161
918,2014,Læknadeild,Meistarapróf,37,86,123
919,2014,Læknadeild,Doktorspróf,21,38,59
920,2014,Matvæla- og næringarfræðideild,,22,87,109
921,2014,Matvæla- og næringarfræðideild,Grunnnám,16,34,50
922,2014,Matvæla- og næringarfræðideild,Viðbótarnám,0,0,0
923,2014,Matvæla- og næringarfræðideild,Meistarapróf,4,45,49
924,2014,Matvæla- og næringarfræðideild,Doktorspróf,2,8,10
925,2014,Sálfræðideild,,108,271,379
926,2014,Sálfræðideild,Grunnnám,91,216,307
927,2014,Sálfræðideild,Viðbótarnám,0,0,0
928,2014,Sálfræðideild,Meistarapróf,13,49,62
929,2014,Sálfræðideild,Doktorspróf,4,6,10
930,2014,Tannlæknadeild,,14,33,47
931,2014,Tannlæknadeild,Grunnnám,14,33,47
932,2014,Tannlæknadeild,Viðbótarnám,0,0,0
933,2014,Tannlæknadeild,Meistarapróf,0,0,0
934,2014,Tannlæknadeild,Doktorspróf,0,0,0
935,2014,"Deild erlendra tungumála, bókmennta og málvísinda",,162,417,579
936,2014,"Deild erlendra tungumála, bókmennta og málvísinda",Grunnnám,133,342,475
937,2014,"Deild erlendra tungumála, bókmennta og málvísinda",Viðbótarnám,0,0,0
938,2014,"Deild erlendra tungumála, bókmennta og málvísinda",Meistarapróf,26,69,95
939,2014,"Deild erlendra tungumála, bókmennta og málvísinda",Doktorspróf,3,6,9
940,2014,Guðfræði- og trúarbragðafræðideild,,37,65,102
941,2014,Guðfræði- og trúarbragðafræðideild,Grunnnám,16,32,48
942,2014,Guðfræði- og trúarbragðafræðideild,Viðbótarnám,1,6,7
943,2014,Guðfræði- og trúarbragðafræðideild,Meistarapróf,17,21,38
944,2014,Guðfræði- og trúarbragðafræðideild,Doktorspróf,3,6,9
945,2014,Íslensku- og menningardeild,,200,572,772
946,2014,Íslensku- og menningardeild,Grunnnám,100,308,408
947,2014,Íslensku- og menningardeild,Viðbótarnám,3,8,11
948,2014,Íslensku- og menningardeild,Meistarapróf,83,231,314
949,2014,Íslensku- og menningardeild,Doktorspróf,14,25,39
950,2014,Sagnfræði- og heimspekideild,,234,200,434
951,2014,Sagnfræði- og heimspekideild,Grunnnám,138,91,229
952,2014,Sagnfræði- og heimspekideild,Viðbótarnám,1,2,3
953,2014,Sagnfræði- og heimspekideild,Meistarapróf,77,92,169
954,2014,Sagnfræði- og heimspekideild,Doktorspróf,18,15,33
955,2014,"Íþrótta-, tómstunda- og þroskaþjálfadeild",,99,229,328
956,2014,"Íþrótta-, tómstunda- og þroskaþjálfadeild",Grunnnám,55,170,225
957,2014,"Íþrótta-, tómstunda- og þroskaþjálfadeild",Viðbótarnám,3,10,13
958,2014,"Íþrótta-, tómstunda- og þroskaþjálfadeild",Meistarapróf,41,49,90
959,2014,"Íþrótta-, tómstunda- og þroskaþjálfadeild",Doktorspróf,0,0,0
960,2014,Kennaradeild,,105,590,695
961,2014,Kennaradeild,Grunnnám,49,245,294
962,2014,Kennaradeild,Viðbótarnám,15,55,70
963,2014,Kennaradeild,Meistarapróf,41,290,331
964,2014,Kennaradeild,Doktorspróf,0,0,0
965,2014,Uppeldis- og menntunarfræðideild,,87,511,701
966,2014,Uppeldis- og menntunarfræðideild,Grunnnám,61,357,103
967,2014,Uppeldis- og menntunarfræðideild,Viðbótarnám,61,357,418
968,2014,Uppeldis- og menntunarfræðideild,Meistarapróf,8,95,103
969,2014,Uppeldis- og menntunarfræðideild,Doktorspróf,18,59,77
970,2014,"Iðnaðarverkfræði-, vélaverkfræði- og tölvunarfræðideild",,393,122,515
971,2014,"Iðnaðarverkfræði-, vélaverkfræði- og tölvunarfræðideild",Grunnnám,302,94,396
972,2014,"Iðnaðarverkfræði-, vélaverkfræði- og tölvunarfræðideild",Viðbótarnám,0,0,0
973,2014,"Iðnaðarverkfræði-, vélaverkfræði- og tölvunarfræðideild",Meistarapróf,86,24,110
974,2014,"Iðnaðarverkfræði-, vélaverkfræði- og tölvunarfræðideild",Doktorspróf,5,4,9
975,2014,Jarðvísindadeild,,110,110,220
976,2014,Jarðvísindadeild,Grunnnám,66,63,129
977,2014,Jarðvísindadeild,Viðbótarnám,0,0,0
978,2014,Jarðvísindadeild,Meistarapróf,30,35,65
979,2014,Jarðvísindadeild,Doktorspróf,14,12,26
980,2014,Líf- og umhverfisvísindadeild,,167,214,381
981,2014,Líf- og umhverfisvísindadeild,Grunnnám,86,133,219
982,2014,Líf- og umhverfisvísindadeild,Viðbótarnám,0,0,0
983,2014,Líf- og umhverfisvísindadeild,Meistarapróf,54,57,111
984,2014,Líf- og umhverfisvísindadeild,Doktorspróf,27,24,51
985,2014,Rafmagns- og tölvuverkfræðideild,,78,6,84
986,2014,Rafmagns- og tölvuverkfræðideild,Grunnnám,58,5,63
987,2014,Rafmagns- og tölvuverkfræðideild,Viðbótarnám,0,0,0
988,2014,Rafmagns- og tölvuverkfræðideild,Meistarapróf,13,1,14
989,2014,Rafmagns- og tölvuverkfræðideild,Doktorspróf,7,0,7
990,2014,Raunvísindadeild,,158,86,244
991,2014,Raunvísindadeild,Grunnnám,102,61,163
992,2014,Raunvísindadeild,Viðbótarnám,0,0,0
993,2014,Raunvísindadeild,Meistarapróf,38,16,54
994,2014,Raunvísindadeild,Doktorspróf,18,9,27
995,2014,Umhverfis- og byggingaverkfræðideild,,83,62,145
996,2014,Umhverfis- og byggingaverkfræðideild,Grunnnám,43,30,73
997,2014,Umhverfis- og byggingaverkfræðideild,Viðbótarnám,0,0,0
998,2014,Umhverfis- og byggingaverkfræðideild,Meistarapróf,37,27,64
999,2014,Umhverfis- og byggingaverkfræðideild,Doktorspróf,3,5,8
1000,2015,Félags- og mannvísindadeild,,190,859,1049
1001,2015,Félags- og mannvísindadeild,Grunnnám,134,441,575
1002,2015,Félags- og mannvísindadeild,Viðbótarnám,17,116,133
1003,2015,Félags- og mannvísindadeild,Meistarapróf,30,261,291
1004,2015,Félags- og mannvísindadeild,Doktorspróf,9,41,50
1005,2015,Félagsráðgjafardeild,,31,361,392
1006,2015,Félagsráðgjafardeild,Grunnnám,25,253,278
1007,2015,Félagsráðgjafardeild,Viðbótarnám,0,15,15
1008,2015,Félagsráðgjafardeild,Meistarapróf,6,90,96
1009,2015,Félagsráðgjafardeild,Doktorspróf,0,3,3
1010,2015,Hagfræðideild,,124,94,218
1011,2015,Hagfræðideild,Grunnnám,78,59,137
1012,2015,Hagfræðideild,Viðbótarnám,9,20,29
1013,2015,Hagfræðideild,Meistarapróf,33,11,44
1014,2015,Hagfræðideild,Doktorspróf,4,4,8
1015,2015,Lagadeild,,282,336,618
1016,2015,Lagadeild,Grunnnám,178,216,394
1017,2015,Lagadeild,Viðbótarnám,0,0,0
1018,2015,Lagadeild,Meistarapróf,99,115,214
1019,2015,Lagadeild,Doktorspróf,5,5,10
1020,2015,Stjórnmálafræðideild,,226,423,649
1021,2015,Stjórnmálafræðideild,Grunnnám,126,107,233
1022,2015,Stjórnmálafræðideild,Viðbótarnám,35,161,196
1023,2015,Stjórnmálafræðideild,Meistarapróf,62,148,210
1024,2015,Stjórnmálafræðideild,Doktorspróf,3,7,10
1025,2015,Viðskiptafræðideild,,598,798,1396
1026,2015,Viðskiptafræðideild,Grunnnám,394,424,818
1027,2015,Viðskiptafræðideild,Viðbótarnám,30,28,58
1028,2015,Viðskiptafræðideild,Meistarapróf,169,339,508
1029,2015,Viðskiptafræðideild,Doktorspróf,5,7,12
1030,2015,Hjúkrunarfræðideild,,5,431,436
1031,2015,Hjúkrunarfræðideild,Grunnnám,1,320,321
1032,2015,Hjúkrunarfræðideild,Viðbótarnám,1,39,40
1033,2015,Hjúkrunarfræðideild,Meistarapróf,3,63,66
1034,2015,Hjúkrunarfræðideild,Doktorspróf,0,9,9
1035,2015,Lyfjafræðideild,,50,134,184
1036,2015,Lyfjafræðideild,Grunnnám,40,93,133
1037,2015,Lyfjafræðideild,Viðbótarnám,0,0,0
1038,2015,Lyfjafræðideild,Meistarapróf,5,27,32
1039,2015,Lyfjafræðideild,Doktorspróf,5,14,19
1040,2015,Læknadeild,,228,441,669
1041,2015,Læknadeild,Grunnnám,119,260,379
1042,2015,Læknadeild,Viðbótarnám,67,92,159
1043,2015,Læknadeild,Meistarapróf,19,44,63
1044,2015,Læknadeild,Doktorspróf,23,45,68
1045,2015,Matvæla- og næringarfræðideild,,27,115,142
1046,2015,Matvæla- og næringarfræðideild,Grunnnám,21,78,99
1047,2015,Matvæla- og næringarfræðideild,Viðbótarnám,0,0,0
1048,2015,Matvæla- og næringarfræðideild,Meistarapróf,4,31,35
1049,2015,Matvæla- og næringarfræðideild,Doktorspróf,2,6,8
1050,2015,Sálfræðideild,,153,416,569
1051,2015,Sálfræðideild,Grunnnám,136,369,505
1052,2015,Sálfræðideild,Viðbótarnám,0,0,0
1053,2015,Sálfræðideild,Meistarapróf,5,9,14
1054,2015,Sálfræðideild,Doktorspróf,12,38,50
1055,2015,Tannlæknadeild,,15,46,61
1056,2015,Tannlæknadeild,Grunnnám,14,46,60
1057,2015,Tannlæknadeild,Viðbótarnám,0,0,0
1058,2015,Tannlæknadeild,Meistarapróf,1,0,1
1059,2015,Tannlæknadeild,Doktorspróf,0,0,0
1060,2015,"Deild erlendra tungumála, bókmennta og málvísinda",,230,564,794
1061,2015,"Deild erlendra tungumála, bókmennta og málvísinda",Grunnnám,202,496,698
1062,2015,"Deild erlendra tungumála, bókmennta og málvísinda",Viðbótarnám,0,0,0
1063,2015,"Deild erlendra tungumála, bókmennta og málvísinda",Meistarapróf,25,60,85
1064,2015,"Deild erlendra tungumála, bókmennta og málvísinda",Doktorspróf,3,8,11
1065,2015,Guðfræði- og trúarbragðafræðideild,,34,57,91
1066,2015,Guðfræði- og trúarbragðafræðideild,Grunnnám,22,32,54
1067,2015,Guðfræði- og trúarbragðafræðideild,Viðbótarnám,0,9,9
1068,2015,Guðfræði- og trúarbragðafræðideild,Meistarapróf,9,12,21
1069,2015,Guðfræði- og trúarbragðafræðideild,Doktorspróf,3,4,7
1070,2015,Íslensku- og menningardeild,,264,714,978
1071,2015,Íslensku- og menningardeild,Grunnnám,171,489,660
1072,2015,Íslensku- og menningardeild,Viðbótarnám,3,8,11
1073,2015,Íslensku- og menningardeild,Meistarapróf,72,189,261
1074,2015,Íslensku- og menningardeild,Doktorspróf,18,28,46
1075,2015,Sagnfræði- og heimspekideild,,290,235,525
1076,2015,Sagnfræði- og heimspekideild,Grunnnám,209,134,343
1077,2015,Sagnfræði- og heimspekideild,Viðbótarnám,6,8,14
1078,2015,Sagnfræði- og heimspekideild,Meistarapróf,62,76,138
1079,2015,Sagnfræði- og heimspekideild,Doktorspróf,13,17,30
1080,2015,"Íþrótta-, tómstunda- og þroskaþjálfadeild",,139,315,454
1081,2015,"Íþrótta-, tómstunda- og þroskaþjálfadeild",Grunnnám,111,258,369
1082,2015,"Íþrótta-, tómstunda- og þroskaþjálfadeild",Viðbótarnám,1,3,4
1083,2015,"Íþrótta-, tómstunda- og þroskaþjálfadeild",Meistarapróf,27,54,81
1084,2015,"Íþrótta-, tómstunda- og þroskaþjálfadeild",Doktorspróf,0,0,0
1085,2015,Kennaradeild,,151,770,921
1086,2015,Kennaradeild,Grunnnám,96,419,515
1087,2015,Kennaradeild,Viðbótarnám,11,40,51
1088,2015,Kennaradeild,Meistarapróf,44,311,355
1089,2015,Kennaradeild,Doktorspróf,0,0,0
1090,2015,Uppeldis- og menntunarfræðideild,,60,519,579
1091,2015,Uppeldis- og menntunarfræðideild,Grunnnám,45,332,377
1092,2015,Uppeldis- og menntunarfræðideild,Viðbótarnám,0,0,0
1093,2015,Uppeldis- og menntunarfræðideild,Meistarapróf,14,181,195
1094,2015,Uppeldis- og menntunarfræðideild,Doktorspróf,1,6,7
1095,2015,"Iðnaðarverkfræði-, vélaverkfræði- og tölvunarfræðideild",,672,233,905
1096,2015,"Iðnaðarverkfræði-, vélaverkfræði- og tölvunarfræðideild",Grunnnám,591,214,805
1097,2015,"Iðnaðarverkfræði-, vélaverkfræði- og tölvunarfræðideild",Viðbótarnám,0,0,0
1098,2015,"Iðnaðarverkfræði-, vélaverkfræði- og tölvunarfræðideild",Meistarapróf,76,14,90
1099,2015,"Iðnaðarverkfræði-, vélaverkfræði- og tölvunarfræðideild",Doktorspróf,5,5,10
1100,2015,Jarðvísindadeild,,102,124,226
1101,2015,Jarðvísindadeild,Grunnnám,70,92,162
1102,2015,Jarðvísindadeild,Viðbótarnám,0,0,0
1103,2015,Jarðvísindadeild,Meistarapróf,19,17,36
1104,2015,Jarðvísindadeild,Doktorspróf,13,15,28
1105,2015,Líf- og umhverfisvísindadeild,,196,345,541
1106,2015,Líf- og umhverfisvísindadeild,Grunnnám,139,280,419
1107,2015,Líf- og umhverfisvísindadeild,Viðbótarnám,0,0,0
1108,2015,Líf- og umhverfisvísindadeild,Meistarapróf,27,41,68
1109,2015,Líf- og umhverfisvísindadeild,Doktorspróf,30,24,54
1110,2015,Rafmagns- og tölvuverkfræðideild,,140,18,158
1111,2015,Rafmagns- og tölvuverkfræðideild,Grunnnám,131,17,148
1112,2015,Rafmagns- og tölvuverkfræðideild,Viðbótarnám,0,0,0
1113,2015,Rafmagns- og tölvuverkfræðideild,Meistarapróf,3,1,4
1114,2015,Rafmagns- og tölvuverkfræðideild,Doktorspróf,6,0,6
1115,2015,Raunvísindadeild,,200,133,333
1116,2015,Raunvísindadeild,Grunnnám,167,118,285
1117,2015,Raunvísindadeild,Viðbótarnám,0,0,0
1118,2015,Raunvísindadeild,Meistarapróf,13,9,22
1119,2015,Raunvísindadeild,Doktorspróf,20,6,26
1120,2015,Umhverfis- og byggingaverkfræðideild,,89,71,160
1121,2015,Umhverfis- og byggingaverkfræðideild,Grunnnám,54,44,98
1122,2015,Umhverfis- og byggingaverkfræðideild,Viðbótarnám,0,0,0
1123,2015,Umhverfis- og byggingaverkfræðideild,Meistarapróf,33,21,54
1124,2015,Umhverfis- og byggingaverkfræðideild,Doktorspróf,2,6,8
1125,2016,Félags- og mannvísindadeild,,192,833,1025
1126,2016,Félags- og mannvísindadeild,Grunnnám,124,410,534
1127,2016,Félags- og mannvísindadeild,Viðbótarnám,14,102,116
1128,2016,Félags- og mannvísindadeild,Meistarapróf,44,285,329
1129,2016,Félags- og mannvísindadeild,Doktorspróf,10,36,46
1130,2016,Félagsráðgjafardeild,,33,394,427
1131,2016,Félagsráðgjafardeild,Grunnnám,23,255,278
1132,2016,Félagsráðgjafardeild,Viðbótarnám,4,36,40
1133,2016,Félagsráðgjafardeild,Meistarapróf,6,100,106
1134,2016,Félagsráðgjafardeild,Doktorspróf,0,3,3
1135,2016,Hagfræðideild,,124,88,212
1136,2016,Hagfræðideild,Grunnnám,83,51,134
1137,2016,Hagfræðideild,Viðbótarnám,6,18,24
1138,2016,Hagfræðideild,Meistarapróf,34,17,51
1139,2016,Hagfræðideild,Doktorspróf,1,2,3
1140,2016,Lagadeild,,257,318,575
1141,2016,Lagadeild,Grunnnám,154,200,354
1142,2016,Lagadeild,Viðbótarnám,0,0,0
1143,2016,Lagadeild,Meistarapróf,99,116,215
1144,2016,Lagadeild,Doktorspróf,4,2,6
1145,2016,Stjórnmálafræðideild,,250,449,699
1146,2016,Stjórnmálafræðideild,Grunnnám,121,137,258
1147,2016,Stjórnmálafræðideild,Viðbótarnám,68,161,229
1148,2016,Stjórnmálafræðideild,Meistarapróf,58,145,203
1149,2016,Stjórnmálafræðideild,Doktorspróf,3,6,9
1150,2016,Viðskiptafræðideild,,626,807,1433
1151,2016,Viðskiptafræðideild,Grunnnám,441,447,888
1152,2016,Viðskiptafræðideild,Viðbótarnám,37,38,75
1153,2016,Viðskiptafræðideild,Meistarapróf,146,314,460
1154,2016,Viðskiptafræðideild,Doktorspróf,2,8,10
1155,2016,Hjúkrunarfræðideild,,12,492,504
1156,2016,Hjúkrunarfræðideild,Grunnnám,7,327,334
1157,2016,Hjúkrunarfræðideild,Viðbótarnám,1,86,87
1158,2016,Hjúkrunarfræðideild,Meistarapróf,4,68,72
1159,2016,Hjúkrunarfræðideild,Doktorspróf,0,11,11
1160,2016,Lyfjafræðideild,,61,159,220
1161,2016,Lyfjafræðideild,Grunnnám,43,98,141
1162,2016,Lyfjafræðideild,Viðbótarnám,0,0,0
1163,2016,Lyfjafræðideild,Meistarapróf,14,49,63
1164,2016,Lyfjafræðideild,Doktorspróf,4,12,16
1165,2016,Læknadeild,,267,518,785
1166,2016,Læknadeild,Grunnnám,134,297,431
1167,2016,Læknadeild,Viðbótarnám,68,98,166
1168,2016,Læknadeild,Meistarapróf,42,78,120
1169,2016,Læknadeild,Doktorspróf,23,45,68
1170,2016,Matvæla- og næringarfræðideild,,22,105,127
1171,2016,Matvæla- og næringarfræðideild,Grunnnám,15,60,75
1172,2016,Matvæla- og næringarfræðideild,Viðbótarnám,0,0,0
1173,2016,Matvæla- og næringarfræðideild,Meistarapróf,6,37,43
1174,2016,Matvæla- og næringarfræðideild,Doktorspróf,1,8,9
1175,2016,Sálfræðideild,,158,407,565
1176,2016,Sálfræðideild,Grunnnám,139,350,489
1177,2016,Sálfræðideild,Viðbótarnám,0,0,0
1178,2016,Sálfræðideild,Meistarapróf,16,50,66
1179,2016,Sálfræðideild,Doktorspróf,3,7,10
1180,2016,Tannlæknadeild,,20,57,77
1181,2016,Tannlæknadeild,Grunnnám,14,44,58
1182,2016,Tannlæknadeild,Viðbótarnám,0,0,0
1183,2016,Tannlæknadeild,Meistarapróf,5,12,17
1184,2016,Tannlæknadeild,Doktorspróf,1,1,2
1185,2016,"Deild erlendra tungumála, bókmennta og málvísinda",,230,552,782
1186,2016,"Deild erlendra tungumála, bókmennta og málvísinda",Grunnnám,197,466,663
1187,2016,"Deild erlendra tungumála, bókmennta og málvísinda",Viðbótarnám,4,11,15
1188,2016,"Deild erlendra tungumála, bókmennta og málvísinda",Meistarapróf,24,68,92
1189,2016,"Deild erlendra tungumála, bókmennta og málvísinda",Doktorspróf,5,7,12
1190,2016,Guðfræði- og trúarbragðafræðideild,,46,64,110
1191,2016,Guðfræði- og trúarbragðafræðideild,Grunnnám,26,28,54
1192,2016,Guðfræði- og trúarbragðafræðideild,Viðbótarnám,0,7,7
1193,2016,Guðfræði- og trúarbragðafræðideild,Meistarapróf,18,24,42
1194,2016,Guðfræði- og trúarbragðafræðideild,Doktorspróf,2,5,7
1195,2016,Íslensku- og menningardeild,,306,756,1062
1196,2016,Íslensku- og menningardeild,Grunnnám,186,497,683
1197,2016,Íslensku- og menningardeild,Viðbótarnám,2,7,9
1198,2016,Íslensku- og menningardeild,Meistarapróf,96,220,316
1199,2016,Íslensku- og menningardeild,Doktorspróf,22,32,54
1200,2016,Sagnfræði- og heimspekideild,,275,228,503
1201,2016,Sagnfræði- og heimspekideild,Grunnnám,189,123,312
1202,2016,Sagnfræði- og heimspekideild,Viðbótarnám,0,6,6
1203,2016,Sagnfræði- og heimspekideild,Meistarapróf,71,79,150
1204,2016,Sagnfræði- og heimspekideild,Doktorspróf,15,20,35
1205,2016,"Íþrótta-, tómstunda- og þroskaþjálfadeild",,134,323,457
1206,2016,"Íþrótta-, tómstunda- og þroskaþjálfadeild",Grunnnám,107,283,390
1207,2016,"Íþrótta-, tómstunda- og þroskaþjálfadeild",Viðbótarnám,2,3,5
1208,2016,"Íþrótta-, tómstunda- og þroskaþjálfadeild",Meistarapróf,25,37,62
1209,2016,"Íþrótta-, tómstunda- og þroskaþjálfadeild",Doktorspróf,0,0,0
1210,2016,Kennaradeild,,156,859,1015
1211,2016,Kennaradeild,Grunnnám,88,447,535
1212,2016,Kennaradeild,Viðbótarnám,32,90,122
1213,2016,Kennaradeild,Meistarapróf,36,322,358
1214,2016,Kennaradeild,Doktorspróf,0,0,0
1215,2016,Uppeldis- og menntunarfræðideild,,69,542,611
1216,2016,Uppeldis- og menntunarfræðideild,Grunnnám,17,171,188
1217,2016,Uppeldis- og menntunarfræðideild,Viðbótarnám,0,55,55
1218,2016,Uppeldis- og menntunarfræðideild,Meistarapróf,40,277,317
1219,2016,Uppeldis- og menntunarfræðideild,Doktorspróf,12,39,51
1220,2016,"Iðnaðarverkfræði-, vélaverkfræði- og tölvunarfræðideild",,579,219,798
1221,2016,"Iðnaðarverkfræði-, vélaverkfræði- og tölvunarfræðideild",Grunnnám,579,219,798
1222,2016,"Iðnaðarverkfræði-, vélaverkfræði- og tölvunarfræðideild",Viðbótarnám,0,0,0
1223,2016,"Iðnaðarverkfræði-, vélaverkfræði- og tölvunarfræðideild",Meistarapróf,0,0,0
1224,2016,"Iðnaðarverkfræði-, vélaverkfræði- og tölvunarfræðideild",Doktorspróf,0,0,0
1225,2016,Jarðvísindadeild,,72,93,165
1226,2016,Jarðvísindadeild,Grunnnám,72,93,165
1227,2016,Jarðvísindadeild,Viðbótarnám,0,0,0
1228,2016,Jarðvísindadeild,Meistarapróf,0,0,0
1229,2016,Jarðvísindadeild,Doktorspróf,0,0,0
1230,2016,Líf- og umhverfisvísindadeild,,140,308,448
1231,2016,Líf- og umhverfisvísindadeild,Grunnnám,140,308,448
1232,2016,Líf- og umhverfisvísindadeild,Viðbótarnám,0,0,0
1233,2016,Líf- og umhverfisvísindadeild,Meistarapróf,0,0,0
1234,2016,Líf- og umhverfisvísindadeild,Doktorspróf,0,0,0
1235,2016,Rafmagns- og tölvuverkfræðideild,,105,27,132
1236,2016,Rafmagns- og tölvuverkfræðideild,Grunnnám,105,27,132
1237,2016,Rafmagns- og tölvuverkfræðideild,Viðbótarnám,0,0,0
1238,2016,Rafmagns- og tölvuverkfræðideild,Meistarapróf,0,0,0
1239,2016,Rafmagns- og tölvuverkfræðideild,Doktorspróf,0,0,0
1240,2016,Raunvísindadeild,,170,117,287
1241,2016,Raunvísindadeild,Grunnnám,170,117,287
1242,2016,Raunvísindadeild,Viðbótarnám,0,0,0
1243,2016,Raunvísindadeild,Meistarapróf,0,0,0
1244,2016,Raunvísindadeild,Doktorspróf,0,0,0
1245,2016,Umhverfis- og byggingaverkfræðideild,,51,37,88
1246,2016,Umhverfis- og byggingaverkfræðideild,Grunnnám,51,37,88
1247,2016,Umhverfis- og byggingaverkfræðideild,Viðbótarnám,0,0,0
1248,2016,Umhverfis- og byggingaverkfræðideild,Meistarapróf,0,0,0
1249,2016,Umhverfis- og byggingaverkfræðideild,Doktorspróf,0,0,0
1250,2017,Félags- og mannvísindadeild,,167,721,888
1251,2017,Félags- og mannvísindadeild,Grunnnám,98,328,426
1252,2017,Félags- og mannvísindadeild,Viðbótarnám,13,84,97
1253,2017,Félags- og mannvísindadeild,Meistarapróf,47,264,311
1254,2017,Félags- og mannvísindadeild,Doktorspróf,9,45,54
1255,2017,Félagsráðgjafardeild,,41,370,411
1256,2017,Félagsráðgjafardeild,Grunnnám,27,236,263
1257,2017,Félagsráðgjafardeild,Viðbótarnám,5,53,58
1258,2017,Félagsráðgjafardeild,Meistarapróf,9,78,87
1259,2017,Félagsráðgjafardeild,Doktorspróf,0,3,3
1260,2017,Hagfræðideild,,106,81,187
1261,2017,Hagfræðideild,Grunnnám,77,53,130
1262,2017,Hagfræðideild,Viðbótarnám,7,4,11
1263,2017,Hagfræðideild,Meistarapróf,18,20,38
1264,2017,Hagfræðideild,Doktorspróf,4,4,8
1265,2017,Lagadeild,,214,301,515
1266,2017,Lagadeild,Grunnnám,123,166,289
1267,2017,Lagadeild,Viðbótarnám,0,0,0
1268,2017,Lagadeild,Meistarapróf,88,132,220
1269,2017,Lagadeild,Doktorspróf,3,3,6
1270,2017,Stjórnmálafræðideild,,232,452,684
1271,2017,Stjórnmálafræðideild,Grunnnám,118,133,251
1272,2017,Stjórnmálafræðideild,Viðbótarnám,52,150,202
1273,2017,Stjórnmálafræðideild,Meistarapróf,59,163,222
1274,2017,Stjórnmálafræðideild,Doktorspróf,3,6,9
1275,2017,Viðskiptafræðideild,,570,781,1351
1276,2017,Viðskiptafræðideild,Grunnnám,383,428,811
1277,2017,Viðskiptafræðideild,Viðbótarnám,36,34,70
1278,2017,Viðskiptafræðideild,Meistarapróf,145,310,455
1279,2017,Viðskiptafræðideild,Doktorspróf,6,9,15
1280,2017,Hjúkrunarfræðideild,,18,529,547
1281,2017,Hjúkrunarfræðideild,Grunnnám,14,344,358
1282,2017,Hjúkrunarfræðideild,Viðbótarnám,2,104,106
1283,2017,Hjúkrunarfræðideild,Meistarapróf,2,70,72
1284,2017,Hjúkrunarfræðideild,Doktorspróf,0,11,11
1285,2017,Lyfjafræðideild,,59,177,236
1286,2017,Lyfjafræðideild,Grunnnám,39,107,146
1287,2017,Lyfjafræðideild,Viðbótarnám,0,0,0
1288,2017,Lyfjafræðideild,Meistarapróf,16,58,74
1289,2017,Lyfjafræðideild,Doktorspróf,4,12,16
1290,2017,Læknadeild,,276,566,842
1291,2017,Læknadeild,Grunnnám,136,323,459
1292,2017,Læknadeild,Viðbótarnám,66,97,163
1293,2017,Læknadeild,Meistarapróf,43,95,138
1294,2017,Læknadeild,Doktorspróf,31,51,82
1295,2017,Matvæla- og næringarfræðideild,,24,94,118
1296,2017,Matvæla- og næringarfræðideild,Grunnnám,16,45,61
1297,2017,Matvæla- og næringarfræðideild,Viðbótarnám,0,0,0
1298,2017,Matvæla- og næringarfræðideild,Meistarapróf,6,39,45
1299,2017,Matvæla- og næringarfræðideild,Doktorspróf,2,10,12
1300,2017,Sálfræðideild,,141,380,521
1301,2017,Sálfræðideild,Grunnnám,121,317,438
1302,2017,Sálfræðideild,Viðbótarnám,0,0,0
1303,2017,Sálfræðideild,Meistarapróf,16,54,70
1304,2017,Sálfræðideild,Doktorspróf,4,9,13
1305,2017,Tannlæknadeild,,41,103,144
1306,2017,Tannlæknadeild,Grunnnám,26,80,106
1307,2017,Tannlæknadeild,Viðbótarnám,7,11,18
1308,2017,Tannlæknadeild,Meistarapróf,7,11,18
1309,2017,Tannlæknadeild,Doktorspróf,1,1,2
1310,2017,"Deild erlendra tungumála, bókmennta og málvísinda",,210,510,720
1311,2017,"Deild erlendra tungumála, bókmennta og málvísinda",Grunnnám,180,442,622
1312,2017,"Deild erlendra tungumála, bókmennta og málvísinda",Viðbótarnám,0,1,1
1313,2017,"Deild erlendra tungumála, bókmennta og málvísinda",Meistarapróf,25,59,84
1314,2017,"Deild erlendra tungumála, bókmennta og málvísinda",Doktorspróf,5,8,13
1315,2017,Guðfræði- og trúarbragðafræðideild,,50,49,99
1316,2017,Guðfræði- og trúarbragðafræðideild,Grunnnám,23,18,41
1317,2017,Guðfræði- og trúarbragðafræðideild,Viðbótarnám,0,5,5
1318,2017,Guðfræði- og trúarbragðafræðideild,Meistarapróf,24,23,47
1319,2017,Guðfræði- og trúarbragðafræðideild,Doktorspróf,3,3,6
1320,2017,Íslensku- og menningardeild,,325,741,1066
1321,2017,Íslensku- og menningardeild,Grunnnám,217,488,705
1322,2017,Íslensku- og menningardeild,Viðbótarnám,1,7,8
1323,2017,Íslensku- og menningardeild,Meistarapróf,81,211,292
1324,2017,Íslensku- og menningardeild,Doktorspróf,26,35,61
1325,2017,Sagnfræði- og heimspekideild,,306,271,577
1326,2017,Sagnfræði- og heimspekideild,Grunnnám,201,141,342
1327,2017,Sagnfræði- og heimspekideild,Viðbótarnám,6,25,31
1328,2017,Sagnfræði- og heimspekideild,Meistarapróf,78,80,158
1329,2017,Sagnfræði- og heimspekideild,Doktorspróf,21,25,46
1330,2017,"Íþrótta-, tómstunda- og þroskaþjálfadeild",,131,341,472
1331,2017,"Íþrótta-, tómstunda- og þroskaþjálfadeild",Grunnnám,109,294,403
1332,2017,"Íþrótta-, tómstunda- og þroskaþjálfadeild",Viðbótarnám,0,5,5
1333,2017,"Íþrótta-, tómstunda- og þroskaþjálfadeild",Meistarapróf,22,42,64
1334,2017,"Íþrótta-, tómstunda- og þroskaþjálfadeild",Doktorspróf,0,0,0
1335,2017,Kennaradeild,,165,812,977
1336,2017,Kennaradeild,Grunnnám,79,342,421
1337,2017,Kennaradeild,Viðbótarnám,36,144,180
1338,2017,Kennaradeild,Meistarapróf,50,326,376
1339,2017,Kennaradeild,Doktorspróf,0,0,0
1340,2017,Uppeldis- og menntunarfræðideild,,76,510,586
1341,2017,Uppeldis- og menntunarfræðideild,Grunnnám,17,162,179
1342,2017,Uppeldis- og menntunarfræðideild,Viðbótarnám,2,55,57
1343,2017,Uppeldis- og menntunarfræðideild,Meistarapróf,40,259,299
1344,2017,Uppeldis- og menntunarfræðideild,Doktorspróf,17,34,51
1345,2017,"Iðnaðarverkfræði-, vélaverkfræði- og tölvunarfræðideild",,608,259,867
1346,2017,"Iðnaðarverkfræði-, vélaverkfræði- og tölvunarfræðideild",Grunnnám,527,228,755
1347,2017,"Iðnaðarverkfræði-, vélaverkfræði- og tölvunarfræðideild",Viðbótarnám,0,0,0
1348,2017,"Iðnaðarverkfræði-, vélaverkfræði- og tölvunarfræðideild",Meistarapróf,73,29,102
1349,2017,"Iðnaðarverkfræði-, vélaverkfræði- og tölvunarfræðideild",Doktorspróf,8,2,10
1350,2017,Jarðvísindadeild,,117,129,246
1351,2017,Jarðvísindadeild,Grunnnám,61,71,132
1352,2017,Jarðvísindadeild,Viðbótarnám,0,0,0
1353,2017,Jarðvísindadeild,Meistarapróf,42,40,82
1354,2017,Jarðvísindadeild,Doktorspróf,14,18,32
1355,2017,Líf- og umhverfisvísindadeild,,223,390,613
1356,2017,Líf- og umhverfisvísindadeild,Grunnnám,162,308,470
1357,2017,Líf- og umhverfisvísindadeild,Viðbótarnám,0,0,0
1358,2017,Líf- og umhverfisvísindadeild,Meistarapróf,38,59,97
1359,2017,Líf- og umhverfisvísindadeild,Doktorspróf,23,23,46
1360,2017,Rafmagns- og tölvuverkfræðideild,,107,34,141
1361,2017,Rafmagns- og tölvuverkfræðideild,Grunnnám,97,33,130
1362,2017,Rafmagns- og tölvuverkfræðideild,Viðbótarnám,0,0,0
1363,2017,Rafmagns- og tölvuverkfræðideild,Meistarapróf,8,1,9
1364,2017,Rafmagns- og tölvuverkfræðideild,Doktorspróf,2,0,2
1365,2017,Raunvísindadeild,,249,148,397
1366,2017,Raunvísindadeild,Grunnnám,174,116,290
1367,2017,Raunvísindadeild,Viðbótarnám,0,0,0
1368,2017,Raunvísindadeild,Meistarapróf,46,19,65
1369,2017,Raunvísindadeild,Doktorspróf,29,13,42
1370,2017,Umhverfis- og byggingaverkfræðideild,,79,64,143
1371,2017,Umhverfis- og byggingaverkfræðideild,Grunnnám,51,42,93
1372,2017,Umhverfis- og byggingaverkfræðideild,Viðbótarnám,0,0,0
1373,2017,Umhverfis- og byggingaverkfræðideild,Meistarapróf,21,14,35
1374,2017,Umhverfis- og byggingaverkfræðideild,Doktorspróf,7,8,15
1375,2018,Félags- og mannvísindadeild,,170,653,823
1376,2018,Félags- og mannvísindadeild,Grunnnám,88,273,361
1377,2018,Félags- og mannvísindadeild,Viðbótarnám,17,98,115
1378,2018,Félags- og mannvísindadeild,Meistarapróf,55,238,293
1379,2018,Félags- og mannvísindadeild,Doktorspróf,10,44,54
1380,2018,Félagsráðgjafardeild,,33,319,352
1381,2018,Félagsráðgjafardeild,Grunnnám,25,215,240
1382,2018,Félagsráðgjafardeild,Viðbótarnám,0,16,16
1383,2018,Félagsráðgjafardeild,Meistarapróf,8,83,91
1384,2018,Félagsráðgjafardeild,Doktorspróf,0,5,5
1385,2018,Hagfræðideild,,122,84,206
1386,2018,Hagfræðideild,Grunnnám,98,59,157
1387,2018,Hagfræðideild,Viðbótarnám,7,12,19
1388,2018,Hagfræðideild,Meistarapróf,13,11,24
1389,2018,Hagfræðideild,Doktorspróf,4,2,6
1390,2018,Lagadeild,,189,264,453
1391,2018,Lagadeild,Grunnnám,92,123,215
1392,2018,Lagadeild,Viðbótarnám,0,0,0
1393,2018,Lagadeild,Meistarapróf,93,137,230
1394,2018,Lagadeild,Doktorspróf,4,4,8
1395,2018,Stjórnmálafræðideild,,232,467,699
1396,2018,Stjórnmálafræðideild,Grunnnám,100,115,215
1397,2018,Stjórnmálafræðideild,Viðbótarnám,62,186,248
1398,2018,Stjórnmálafræðideild,Meistarapróf,67,161,228
1399,2018,Stjórnmálafræðideild,Doktorspróf,3,5,8
1400,2018,Viðskiptafræðideild,,527,753,1300
1401,2018,Viðskiptafræðideild,Grunnnám,356,408,764
1402,2018,Viðskiptafræðideild,Meistarapróf,165,331,20
1403,2018,Viðskiptafræðideild,Doktorspróf,6,14,20
1404,2018,Hjúkrunarfræðideild,,17,543,560
1405,2018,Hjúkrunarfræðideild,Grunnnám,10,354,364
1406,2018,Hjúkrunarfræðideild,Viðbótarnám,5,106,111
1407,2018,Hjúkrunarfræðideild,Meistarapróf,2,71,73
1408,2018,Hjúkrunarfræðideild,Doktorspróf,0,12,12
1409,2018,Lyfjafræðideild,,54,139,193
1410,2018,Lyfjafræðideild,Grunnnám,28,75,103
1411,2018,Lyfjafræðideild,Viðbótarnám,0,0,0
1412,2018,Lyfjafræðideild,Meistarapróf,22,52,74
1413,2018,Lyfjafræðideild,Doktorspróf,4,12,16
1414,2018,Læknadeild,,280,583,863
1415,2018,Læknadeild,Grunnnám,126,305,431
1416,2018,Læknadeild,Viðbótarnám,60,112,172
1417,2018,Læknadeild,Meistarapróf,60,109,169
1418,2018,Læknadeild,Doktorspróf,34,57,91
1419,2018,Matvæla- og næringarfræðideild,,23,103,126
1420,2018,Matvæla- og næringarfræðideild,Grunnnám,11,46,57
1421,2018,Matvæla- og næringarfræðideild,Viðbótarnám,0,0,0
1422,2018,Matvæla- og næringarfræðideild,Meistarapróf,10,42,52
1423,2018,Matvæla- og næringarfræðideild,Doktorspróf,2,15,17
1424,2018,Sálfræðideild,,150,384,534
1425,2018,Sálfræðideild,Grunnnám,123,310,433
1426,2018,Sálfræðideild,Viðbótarnám,0,0,0
1427,2018,Sálfræðideild,Meistarapróf,20,62,82
1428,2018,Sálfræðideild,Doktorspróf,7,12,19
1429,2018,Tannlæknadeild,,32,110,142
1430,2018,Tannlæknadeild,Grunnnám,27,99,126
1431,2018,Tannlæknadeild,Viðbótarnám,0,0,0
1432,2018,Tannlæknadeild,Meistarapróf,4,10,14
1433,2018,Tannlæknadeild,Doktorspróf,1,1,2
1434,2018,"Deild erlendra tungumála, bókmennta og málvísinda",,209,518,727
1435,2018,"Deild erlendra tungumála, bókmennta og málvísinda",Grunnnám,178,424,602
1436,2018,"Deild erlendra tungumála, bókmennta og málvísinda",Viðbótarnám,5,21,26
1437,2018,"Deild erlendra tungumála, bókmennta og málvísinda",Meistarapróf,21,65,86
1438,2018,"Deild erlendra tungumála, bókmennta og málvísinda",Doktorspróf,5,8,13
1439,2018,Guðfræði- og trúarbragðafræðideild,,45,36,81
1440,2018,Guðfræði- og trúarbragðafræðideild,Grunnnám,20,16,36
1441,2018,Guðfræði- og trúarbragðafræðideild,Viðbótarnám,0,0,0
1442,2018,Guðfræði- og trúarbragðafræðideild,Meistarapróf,22,17,39
1443,2018,Guðfræði- og trúarbragðafræðideild,Doktorspróf,3,3,6
1444,2018,Íslensku- og menningardeild,,335,722,1057
1445,2018,Íslensku- og menningardeild,Grunnnám,212,462,674
1446,2018,Íslensku- og menningardeild,Viðbótarnám,1,4,5
1447,2018,Íslensku- og menningardeild,Meistarapróf,92,220,312
1448,2018,Íslensku- og menningardeild,Doktorspróf,30,36,66
1449,2018,Sagnfræði- og heimspekideild,,274,253,527
1450,2018,Sagnfræði- og heimspekideild,Grunnnám,170,103,273
1451,2018,Sagnfræði- og heimspekideild,Viðbótarnám,9,20,29
1452,2018,Sagnfræði- og heimspekideild,Meistarapróf,71,103,174
1453,2018,Sagnfræði- og heimspekideild,Doktorspróf,24,27,51
1454,2018,"Íþrótta-, tómstunda- og þroskaþjálfadeild",,151,342,493
1455,2018,"Íþrótta-, tómstunda- og þroskaþjálfadeild",Grunnnám,130,311,441
1456,2018,"Íþrótta-, tómstunda- og þroskaþjálfadeild",Viðbótarnám,0,3,3
1457,2018,"Íþrótta-, tómstunda- og þroskaþjálfadeild",Meistarapróf,21,28,49
1458,2018,"Íþrótta-, tómstunda- og þroskaþjálfadeild",Doktorspróf,0,0,0
1459,2018,Kennaradeild,,145,769,914
1460,2018,Kennaradeild,Grunnnám,88,382,470
1461,2018,Kennaradeild,Viðbótarnám,17,68,85
1462,2018,Kennaradeild,Meistarapróf,40,319,359
1463,2018,Kennaradeild,Doktorspróf,0,0,0
1464,2018,Uppeldis- og menntunarfræðideild,,78,538,616
1465,2018,Uppeldis- og menntunarfræðideild,Grunnnám,15,187,202
1466,2018,Uppeldis- og menntunarfræðideild,Viðbótarnám,4,69,73
1467,2018,Uppeldis- og menntunarfræðideild,Meistarapróf,42,248,290
1468,2018,Uppeldis- og menntunarfræðideild,Doktorspróf,17,34,51
1469,2018,"Iðnaðarverkfræði-, vélaverkfræði- og tölvunarfræðideild",,582,241,823
1470,2018,"Iðnaðarverkfræði-, vélaverkfræði- og tölvunarfræðideild",Grunnnám,484,206,690
1471,2018,"Iðnaðarverkfræði-, vélaverkfræði- og tölvunarfræðideild",Viðbótarnám,0,0,0
1472,2018,"Iðnaðarverkfræði-, vélaverkfræði- og tölvunarfræðideild",Meistarapróf,87,31,118
1473,2018,"Iðnaðarverkfræði-, vélaverkfræði- og tölvunarfræðideild",Doktorspróf,11,4,15
1474,2018,Jarðvísindadeild,,82,145,227
1475,2018,Jarðvísindadeild,Grunnnám,27,65,92
1476,2018,Jarðvísindadeild,Viðbótarnám,0,0,0
1477,2018,Jarðvísindadeild,Meistarapróf,42,57,99
1478,2018,Jarðvísindadeild,Doktorspróf,13,23,36
1479,2018,Líf- og umhverfisvísindadeild,,199,319,506
1480,2018,Líf- og umhverfisvísindadeild,Grunnnám,129,242,371
1481,2018,Líf- og umhverfisvísindadeild,Viðbótarnám,0,0,0
1482,2018,Líf- og umhverfisvísindadeild,Meistarapróf,44,53,99
1483,2018,Líf- og umhverfisvísindadeild,Doktorspróf,26,24,36
1484,2018,Rafmagns- og tölvuverkfræðideild,,81,26,107
1485,2018,Rafmagns- og tölvuverkfræðideild,Grunnnám,81,26,107
1486,2018,Rafmagns- og tölvuverkfræðideild,Viðbótarnám,0,0,0
1487,2018,Rafmagns- og tölvuverkfræðideild,Meistarapróf,0,0,0
1488,2018,Rafmagns- og tölvuverkfræðideild,Doktorspróf,0,0,0
1489,2018,Raunvísindadeild,,256,154,410
1490,2018,Raunvísindadeild,Grunnnám,166,123,289
1491,2018,Raunvísindadeild,Viðbótarnám,0,0,0
1492,2018,Raunvísindadeild,Meistarapróf,55,18,73
1493,2018,Raunvísindadeild,Doktorspróf,35,13,48
1494,2018,Umhverfis- og byggingaverkfræðideild,,98,64,162
1495,2018,Umhverfis- og byggingaverkfræðideild,Grunnnám,55,42,97
1496,2018,Umhverfis- og byggingaverkfræðideild,Viðbótarnám,0,0,0
1497,2018,Umhverfis- og byggingaverkfræðideild,Meistarapróf,34,17,51
1498,2018,Umhverfis- og byggingaverkfræðideild,Doktorspróf,9,5,14
1499,2019,Félags- og mannvísindadeild,,164,650,814
1500,2019,Félags- og mannvísindadeild,Grunnnám,81,270,351
1501,2019,Félags- og mannvísindadeild,Viðbótarnám,18,102,120
1502,2019,Félags- og mannvísindadeild,Meistarapróf,54,235,289
1503,2019,Félags- og mannvísindadeild,Doktorspróf,11,43,54
1504,2019,Félagsráðgjafardeild,,26,314,340
1505,2019,Félagsráðgjafardeild,Grunnnám,23,204,227
1506,2019,Félagsráðgjafardeild,Viðbótarnám,1,22,23
1507,2019,Félagsráðgjafardeild,Meistarapróf,2,83,85
1508,2019,Félagsráðgjafardeild,Doktorspróf,0,5,5
1509,2019,Hagfræðideild,,166,87,253
1510,2019,Hagfræðideild,Grunnnám,128,54,182
1511,2019,Hagfræðideild,Viðbótarnám,18,14,32
1512,2019,Hagfræðideild,Meistarapróf,16,16,32
1513,2019,Hagfræðideild,Doktorspróf,4,3,7
1514,2019,Lagadeild,,176,222,398
1515,2019,Lagadeild,Grunnnám,90,110,200
1516,2019,Lagadeild,Viðbótarnám,0,0,0
1517,2019,Lagadeild,Meistarapróf,82,109,191
1518,2019,Lagadeild,Doktorspróf,4,3,7
1519,2019,Stjórnmálafræðideild,,216,424,640
1520,2019,Stjórnmálafræðideild,Grunnnám,82,95,177
1521,2019,Stjórnmálafræðideild,Viðbótarnám,76,196,272
1522,2019,Stjórnmálafræðideild,Meistarapróf,55,131,186
1523,2019,Stjórnmálafræðideild,Doktorspróf,3,2,5
1524,2019,Viðskiptafræðideild,,484,670,1154
1525,2019,Viðskiptafræðideild,Grunnnám,312,327,639
1526,2019,Viðskiptafræðideild,Viðbótarnám,0,0,0
1527,2019,Viðskiptafræðideild,Meistarapróf,165,325,490
1528,2019,Viðskiptafræðideild,Doktorspróf,7,18,25
1529,2019,Hjúkrunarfræðideild,,24,561,585
1530,2019,Hjúkrunarfræðideild,Grunnnám,17,361,378
1531,2019,Hjúkrunarfræðideild,Viðbótarnám,5,112,117
1532,2019,Hjúkrunarfræðideild,Meistarapróf,2,75,77
1533,2019,Hjúkrunarfræðideild,Doktorspróf,0,13,13
1534,2019,Lyfjafræðideild,,59,135,194
1535,2019,Lyfjafræðideild,Grunnnám,27,72,99
1536,2019,Lyfjafræðideild,Viðbótarnám,0,0,0
1537,2019,Lyfjafræðideild,Meistarapróf,27,55,82
1538,2019,Lyfjafræðideild,Doktorspróf,5,8,13
1539,2019,Læknadeild,,286,600,886
1540,2019,Læknadeild,Grunnnám,134,307,441
1541,2019,Læknadeild,Viðbótarnám,61,121,182
1542,2019,Læknadeild,Meistarapróf,58,118,176
1543,2019,Læknadeild,Doktorspróf,33,54,87
1544,2019,Matvæla- og næringarfræðideild,,37,106,143
1545,2019,Matvæla- og næringarfræðideild,Grunnnám,23,48,71
1546,2019,Matvæla- og næringarfræðideild,Viðbótarnám,0,0,0
1547,2019,Matvæla- og næringarfræðideild,Meistarapróf,12,43,55
1548,2019,Matvæla- og næringarfræðideild,Doktorspróf,2,15,17
1549,2019,Sálfræðideild,,162,427,589
1550,2019,Sálfræðideild,Grunnnám,141,353,494
1551,2019,Sálfræðideild,Viðbótarnám,0,0,0
1552,2019,Sálfræðideild,Meistarapróf,17,65,82
1553,2019,Sálfræðideild,Doktorspróf,4,9,13
1554,2019,Tannlæknadeild,,21,75,98
1555,2019,Tannlæknadeild,Grunnnám,15,65,80
1556,2019,Tannlæknadeild,Viðbótarnám,0,0,14
1557,2019,Tannlæknadeild,Meistarapróf,5,9,2
1558,2019,Tannlæknadeild,Doktorspróf,1,1,2
1559,2019,"Deild erlendra tungumála, bókmennta og málvísinda",,185,493,678
1560,2019,"Deild erlendra tungumála, bókmennta og málvísinda",Grunnnám,152,396,548
1561,2019,"Deild erlendra tungumála, bókmennta og málvísinda",Viðbótarnám,7,16,23
1562,2019,"Deild erlendra tungumála, bókmennta og málvísinda",Meistarapróf,19,71,90
1563,2019,"Deild erlendra tungumála, bókmennta og málvísinda",Doktorspróf,7,10,17
1564,2019,Guðfræði- og trúarbragðafræðideild,,39,47,86
1565,2019,Guðfræði- og trúarbragðafræðideild,Grunnnám,16,19,35
1566,2019,Guðfræði- og trúarbragðafræðideild,Viðbótarnám,0,6,6
1567,2019,Guðfræði- og trúarbragðafræðideild,Meistarapróf,21,20,41
1568,2019,Guðfræði- og trúarbragðafræðideild,Doktorspróf,2,2,4
1569,2019,Íslensku- og menningardeild,,355,760,1115
1570,2019,Íslensku- og menningardeild,Grunnnám,221,506,727
1571,2019,Íslensku- og menningardeild,Viðbótarnám,2,7,9
1572,2019,Íslensku- og menningardeild,Meistarapróf,104,208,312
1573,2019,Íslensku- og menningardeild,Doktorspróf,28,39,67
1574,2019,Sagnfræði- og heimspekideild,,276,231,507
1575,2019,Sagnfræði- og heimspekideild,Grunnnám,174,99,273
1576,2019,Sagnfræði- og heimspekideild,Viðbótarnám,9,20,29
1577,2019,Sagnfræði- og heimspekideild,Meistarapróf,68,87,155
1578,2019,Sagnfræði- og heimspekideild,Doktorspróf,25,25,50
1579,2019,"Íþrótta-, tómstunda- og þroskaþjálfadeild",,148,253,401
1580,2019,"Íþrótta-, tómstunda- og þroskaþjálfadeild",Grunnnám,127,180,307
1581,2019,"Íþrótta-, tómstunda- og þroskaþjálfadeild",Viðbótarnám,0,0,0
1582,2019,"Íþrótta-, tómstunda- og þroskaþjálfadeild",Meistarapróf,2,41,43
1583,2019,"Íþrótta-, tómstunda- og þroskaþjálfadeild",Doktorspróf,19,32,51
1584,2019,Kennaradeild,,220,934,1154
1585,2019,Kennaradeild,Grunnnám,143,431,574
1586,2019,Kennaradeild,Viðbótarnám,16,106,122
1587,2019,Kennaradeild,Meistarapróf,61,397,458
1588,2019,Kennaradeild,Doktorspróf,0,0,0
1589,2019,Uppeldis- og menntunarfræðideild,,82,638,720
1590,2019,Uppeldis- og menntunarfræðideild,Grunnnám,36,326,362
1591,2019,Uppeldis- og menntunarfræðideild,Viðbótarnám,0,75,75
1592,2019,Uppeldis- og menntunarfræðideild,Meistarapróf,30,202,232
1593,2019,Uppeldis- og menntunarfræðideild,Doktorspróf,16,35,51
1594,2019,"Iðnaðarverkfræði-, vélaverkfræði- og tölvunarfræðideild",,601,262,863
1595,2019,"Iðnaðarverkfræði-, vélaverkfræði- og tölvunarfræðideild",Grunnnám,506,224,730
1596,2019,"Iðnaðarverkfræði-, vélaverkfræði- og tölvunarfræðideild",Viðbótarnám,0,0,0
1597,2019,"Iðnaðarverkfræði-, vélaverkfræði- og tölvunarfræðideild",Meistarapróf,82,32,114
1598,2019,"Iðnaðarverkfræði-, vélaverkfræði- og tölvunarfræðideild",Doktorspróf,13,6,19
1599,2019,Jarðvísindadeild,,75,106,181
1600,2019,Jarðvísindadeild,Grunnnám,27,38,65
1601,2019,Jarðvísindadeild,Viðbótarnám,0,0,0
1602,2019,Jarðvísindadeild,Meistarapróf,36,46,82
1603,2019,Jarðvísindadeild,Doktorspróf,12,22,34
1604,2019,Líf- og umhverfisvísindadeild,,176,275,451
1605,2019,Líf- og umhverfisvísindadeild,Grunnnám,119,200,319
1606,2019,Líf- og umhverfisvísindadeild,Viðbótarnám,0,0,0
1607,2019,Líf- og umhverfisvísindadeild,Meistarapróf,36,51,87
1608,2019,Líf- og umhverfisvísindadeild,Doktorspróf,21,24,45
1609,2019,Rafmagns- og tölvuverkfræðideild,,103,29,132
1610,2019,Rafmagns- og tölvuverkfræðideild,Grunnnám,87,28,115
1611,2019,Rafmagns- og tölvuverkfræðideild,Viðbótarnám,0,0,0
1612,2019,Rafmagns- og tölvuverkfræðideild,Meistarapróf,13,1,14
1613,2019,Rafmagns- og tölvuverkfræðideild,Doktorspróf,3,0,3
1614,2019,Raunvísindadeild,,239,150,389
1615,2019,Raunvísindadeild,Grunnnám,152,122,274
1616,2019,Raunvísindadeild,Viðbótarnám,0,0,0
1617,2019,Raunvísindadeild,Meistarapróf,51,16,67
1618,2019,Raunvísindadeild,Doktorspróf,36,12,48
1619,2019,Umhverfis- og byggingaverkfræðideild,,90,65,155
1620,2019,Umhverfis- og byggingaverkfræðideild,Grunnnám,50,45,95
1621,2019,Umhverfis- og byggingaverkfræðideild,Viðbótarnám,0,0,0
1622,2019,Umhverfis- og byggingaverkfræðideild,Meistarapróf,30,17,47
1623,2019,Umhverfis- og byggingaverkfræðideild,Doktorspróf,10,3,13
1624,2020,Félags- og mannvísindadeild,,183,649,832
1625,2020,Félags- og mannvísindadeild,Grunnnám,85,245,330
1626,2020,Félags- og mannvísindadeild,Viðbótarnám,23,106,129
1627,2020,Félags- og mannvísindadeild,Meistarapróf,62,252,314
1628,2020,Félags- og mannvísindadeild,Doktorspróf,13,46,59
1629,2020,Félagsráðgjafardeild,,23,365,388
1630,2020,Félagsráðgjafardeild,Grunnnám,19,253,272
1631,2020,Félagsráðgjafardeild,Viðbótarnám,0,28,28
1632,2020,Félagsráðgjafardeild,Meistarapróf,4,80,84
1633,2020,Félagsráðgjafardeild,Doktorspróf,0,4,4
1634,2020,Hagfræðideild,,188,104,292
1635,2020,Hagfræðideild,Grunnnám,141,72,213
1636,2020,Hagfræðideild,Viðbótarnám,14,18,32
1637,2020,Hagfræðideild,Meistarapróf,28,12,40
1638,2020,Hagfræðideild,Doktorspróf,5,2,7
1639,2020,Lagadeild,,179,209,388
1640,2020,Lagadeild,Grunnnám,108,105,213
1641,2020,Lagadeild,Viðbótarnám,0,0,0
1642,2020,Lagadeild,Meistarapróf,68,102,170
1643,2020,Lagadeild,Doktorspróf,3,2,5
1644,2020,Stjórnmálafræðideild,,217,481,698
1645,2020,Stjórnmálafræðideild,Grunnnám,77,89,166
1646,2020,Stjórnmálafræðideild,Viðbótarnám,82,239,321
1647,2020,Stjórnmálafræðideild,Meistarapróf,54,149,203
1648,2020,Stjórnmálafræðideild,Doktorspróf,4,4,8
1649,2020,Viðskiptafræðideild,,475,753,1228
1650,2020,Viðskiptafræðideild,Grunnnám,308,335,643
1651,2020,Viðskiptafræðideild,Viðbótarnám,0,0,0
1652,2020,Viðskiptafræðideild,Meistarapróf,161,401,562
1653,2020,Viðskiptafræðideild,Doktorspróf,6,17,23
1654,2020,Hjúkrunarfræðideild,,36,742,778
1655,2020,Hjúkrunarfræðideild,Grunnnám,26,505,531
1656,2020,Hjúkrunarfræðideild,Viðbótarnám,7,120,127
1657,2020,Hjúkrunarfræðideild,Meistarapróf,3,99,102
1658,2020,Hjúkrunarfræðideild,Doktorspróf,0,18,18
1659,2020,Lyfjafræðideild,,58,132,190
1660,2020,Lyfjafræðideild,Grunnnám,32,71,103
1661,2020,Lyfjafræðideild,Viðbótarnám,0,0,0
1662,2020,Lyfjafræðideild,Meistarapróf,21,53,74
1663,2020,Lyfjafræðideild,Doktorspróf,5,8,13
1664,2020,Læknadeild,,275,758,1033
1665,2020,Læknadeild,Grunnnám,138,457,595
1666,2020,Læknadeild,Viðbótarnám,54,117,171
1667,2020,Læknadeild,Meistarapróf,54,129,183
1668,2020,Læknadeild,Doktorspróf,29,55,84
1669,2020,Matvæla- og næringarfræðideild,,40,125,165
1670,2020,Matvæla- og næringarfræðideild,Grunnnám,28,63,91
1671,2020,Matvæla- og næringarfræðideild,Viðbótarnám,0,0,0
1672,2020,Matvæla- og næringarfræðideild,Meistarapróf,9,44,53
1673,2020,Matvæla- og næringarfræðideild,Doktorspróf,3,18,21
1674,2020,Sálfræðideild,,186,498,684
1675,2020,Sálfræðideild,Grunnnám,163,416,579
1676,2020,Sálfræðideild,Viðbótarnám,0,0,0
1677,2020,Sálfræðideild,Meistarapróf,17,72,89
1678,2020,Sálfræðideild,Doktorspróf,6,10,16
1679,2020,Tannlæknadeild,,15,61,76
1680,2020,Tannlæknadeild,Grunnnám,10,55,65
1681,2020,Tannlæknadeild,Viðbótarnám,0,0,0
1682,2020,Tannlæknadeild,Meistarapróf,4,5,9
1683,2020,Tannlæknadeild,Doktorspróf,1,1,2
1684,2020,"Deild erlendra tungumála, bókmennta og málvísinda",,231,519,750
1685,2020,"Deild erlendra tungumála, bókmennta og málvísinda",Grunnnám,193,426,619
1686,2020,"Deild erlendra tungumála, bókmennta og málvísinda",Viðbótarnám,6,14,20
1687,2020,"Deild erlendra tungumála, bókmennta og málvísinda",Meistarapróf,25,68,93
1688,2020,"Deild erlendra tungumála, bókmennta og málvísinda",Doktorspróf,7,11,18
1689,2020,Guðfræði- og trúarbragðafræðideild,,37,35,72
1690,2020,Guðfræði- og trúarbragðafræðideild,Grunnnám,19,22,41
1691,2020,Guðfræði- og trúarbragðafræðideild,Viðbótarnám,0,1,1
1692,2020,Guðfræði- og trúarbragðafræðideild,Meistarapróf,16,11,27
1693,2020,Guðfræði- og trúarbragðafræðideild,Doktorspróf,2,1,3
1694,2020,Íslensku- og menningardeild,,295,719,1014
1695,2020,Íslensku- og menningardeild,Grunnnám,169,468,637
1696,2020,Íslensku- og menningardeild,Viðbótarnám,1,6,7
1697,2020,Íslensku- og menningardeild,Meistarapróf,97,205,302
1698,2020,Íslensku- og menningardeild,Doktorspróf,28,40,68
1699,2020,Sagnfræði- og heimspekideild,,267,225,492
1700,2020,Sagnfræði- og heimspekideild,Grunnnám,159,84,243
1701,2020,Sagnfræði- og heimspekideild,Viðbótarnám,7,29,36
1702,2020,Sagnfræði- og heimspekideild,Meistarapróf,76,90,166
1703,2020,Sagnfræði- og heimspekideild,Doktorspróf,25,22,47
1704,2020,"Íþrótta-, tómstunda- og þroskaþjálfadeild",,179,260,439
1705,2020,"Íþrótta-, tómstunda- og þroskaþjálfadeild",Grunnnám,145,190,335
1706,2020,"Íþrótta-, tómstunda- og þroskaþjálfadeild",Viðbótarnám,5,22,27
1707,2020,"Íþrótta-, tómstunda- og þroskaþjálfadeild",Meistarapróf,29,48,77
1708,2020,"Íþrótta-, tómstunda- og þroskaþjálfadeild",Doktorspróf,0,0,0
1709,2020,Kennaradeild,,250,1199,1449
1710,2020,Kennaradeild,Grunnnám,143,535,678
1711,2020,Kennaradeild,Viðbótarnám,26,162,188
1712,2020,Kennaradeild,Meistarapróf,81,502,583
1713,2020,Kennaradeild,Doktorspróf,0,0,0
1714,2020,Uppeldis- og menntunarfræðideild,,87,625,712
1715,2020,Uppeldis- og menntunarfræðideild,Grunnnám,42,339,381
1716,2020,Uppeldis- og menntunarfræðideild,Viðbótarnám,3,64,67
1717,2020,Uppeldis- og menntunarfræðideild,Meistarapróf,27,184,211
1718,2020,Uppeldis- og menntunarfræðideild,Doktorspróf,15,38,53
1719,2020,"Iðnaðarverkfræði-, vélaverkfræði- og tölvunarfræðideild",,580,236,816
1720,2020,"Iðnaðarverkfræði-, vélaverkfræði- og tölvunarfræðideild",Grunnnám,480,203,683
1721,2020,"Iðnaðarverkfræði-, vélaverkfræði- og tölvunarfræðideild",Viðbótarnám,0,0,0
1722,2020,"Iðnaðarverkfræði-, vélaverkfræði- og tölvunarfræðideild",Meistarapróf,84,25,109
1723,2020,"Iðnaðarverkfræði-, vélaverkfræði- og tölvunarfræðideild",Doktorspróf,16,8,24
1724,2020,Jarðvísindadeild,,68,106,174
1725,2020,Jarðvísindadeild,Grunnnám,26,39,65
1726,2020,Jarðvísindadeild,Viðbótarnám,0,0,0
1727,2020,Jarðvísindadeild,Meistarapróf,32,50,82
1728,2020,Jarðvísindadeild,Doktorspróf,10,17,27
1729,2020,Líf- og umhverfisvísindadeild,,152,282,434
1730,2020,Líf- og umhverfisvísindadeild,Grunnnám,95,191,286
1731,2020,Líf- og umhverfisvísindadeild,Viðbótarnám,0,0,0
1732,2020,Líf- og umhverfisvísindadeild,Meistarapróf,41,60,101
1733,2020,Líf- og umhverfisvísindadeild,Doktorspróf,16,31,47
1734,2020,Rafmagns- og tölvuverkfræðideild,,129,33,162
1735,2020,Rafmagns- og tölvuverkfræðideild,Grunnnám,111,29,140
1736,2020,Rafmagns- og tölvuverkfræðideild,Viðbótarnám,0,0,0
1737,2020,Rafmagns- og tölvuverkfræðideild,Meistarapróf,15,3,18
1738,2020,Rafmagns- og tölvuverkfræðideild,Doktorspróf,3,1,4
1739,2020,Raunvísindadeild,,248,158,406
1740,2020,Raunvísindadeild,Grunnnám,158,127,285
1741,2020,Raunvísindadeild,Viðbótarnám,0,0,0
1742,2020,Raunvísindadeild,Meistarapróf,52,17,69
1743,2020,Raunvísindadeild,Doktorspróf,38,14,52
1744,2020,Umhverfis- og byggingaverkfræðideild,,90,73,163
1745,2020,Umhverfis- og byggingaverkfræðideild,Grunnnám,51,57,108
1746,2020,Umhverfis- og byggingaverkfræðideild,Viðbótarnám,0,0,0
1747,2020,Umhverfis- og byggingaverkfræðideild,Meistarapróf,32,12,44
1748,2020,Umhverfis- og byggingaverkfræðideild,Doktorspróf,7,4,11
1749,2021,Félags- og mannvísindadeild,,194,749,943
1750,2021,Félags- og mannvísindadeild,Grunnnám,94,288,382
1751,2021,Félags- og mannvísindadeild,Viðbótarnám,28,116,144
1752,2021,Félags- og mannvísindadeild,Meistarapróf,59,294,353
1753,2021,Félags- og mannvísindadeild,Doktorspróf,13,51,64
1754,2021,Félagsráðgjafardeild,,47,502,549
1755,2021,Félagsráðgjafardeild,Grunnnám,39,360,399
1756,2021,Félagsráðgjafardeild,Viðbótarnám,4,44,48
1757,2021,Félagsráðgjafardeild,Meistarapróf,4,94,98
1758,2021,Félagsráðgjafardeild,Doktorspróf,0,4,4
1759,2021,Hagfræðideild,,185,183,368
1760,2021,Hagfræðideild,Grunnnám,141,160,301
1761,2021,Hagfræðideild,Viðbótarnám,10,13,23
1762,2021,Hagfræðideild,Meistarapróf,27,7,34
1763,2021,Hagfræðideild,Doktorspróf,7,3,10
1764,2021,Lagadeild,,207,285,492
1765,2021,Lagadeild,Grunnnám,138,173,311
1766,2021,Lagadeild,Viðbótarnám,0,0,0
1767,2021,Lagadeild,Meistarapróf,66,110,176
1768,2021,Lagadeild,Doktorspróf,3,2,5
1769,2021,Stjórnmálafræðideild,,314,579,893
1770,2021,Stjórnmálafræðideild,Grunnnám,103,96,199
1771,2021,Stjórnmálafræðideild,Viðbótarnám,120,284,404
1772,2021,Stjórnmálafræðideild,Meistarapróf,86,195,281
1773,2021,Stjórnmálafræðideild,Doktorspróf,5,4,9
1774,2021,Viðskiptafræðideild,,559,845,1404
1775,2021,Viðskiptafræðideild,Grunnnám,349,362,711
1776,2021,Viðskiptafræðideild,Viðbótarnám,38,27,65
1777,2021,Viðskiptafræðideild,Meistarapróf,165,440,605
1778,2021,Viðskiptafræðideild,Doktorspróf,7,16,23
1779,2021,Hjúkrunarfræðideild,,34,773,807
1780,2021,Hjúkrunarfræðideild,Grunnnám,28,547,575
1781,2021,Hjúkrunarfræðideild,Viðbótarnám,6,87,93
1782,2021,Hjúkrunarfræðideild,Meistarapróf,0,123,123
1783,2021,Hjúkrunarfræðideild,Doktorspróf,0,16,16
1784,2021,Lyfjafræðideild,,52,135,187
1785,2021,Lyfjafræðideild,Grunnnám,26,85,111
1786,2021,Lyfjafræðideild,Viðbótarnám,0,0,0
1787,2021,Lyfjafræðideild,Meistarapróf,21,41,62
1788,2021,Lyfjafræðideild,Doktorspróf,5,9,14
1789,2021,Læknadeild,,327,805,1132
1790,2021,Læknadeild,Grunnnám,173,504,677
1791,2021,Læknadeild,Viðbótarnám,53,108,161
1792,2021,Læknadeild,Meistarapróf,67,137,204
1793,2021,Læknadeild,Doktorspróf,34,56,90
1794,2021,Matvæla- og næringarfræðideild,,59,139,198
1795,2021,Matvæla- og næringarfræðideild,Grunnnám,47,85,132
1796,2021,Matvæla- og næringarfræðideild,Viðbótarnám,0,0,0
1797,2021,Matvæla- og næringarfræðideild,Meistarapróf,10,38,48
1798,2021,Matvæla- og næringarfræðideild,Doktorspróf,2,16,18
1799,2021,Sálfræðideild,,234,555,789
1800,2021,Sálfræðideild,Grunnnám,204,480,684
1801,2021,Sálfræðideild,Viðbótarnám,0,0,0
1802,2021,Sálfræðideild,Meistarapróf,22,66,88
1803,2021,Sálfræðideild,Doktorspróf,8,9,17
1804,2021,Tannlæknadeild,,15,63,78
1805,2021,Tannlæknadeild,Grunnnám,11,60,71
1806,2021,Tannlæknadeild,Viðbótarnám,0,0,0
1807,2021,Tannlæknadeild,Meistarapróf,3,2,5
1808,2021,Tannlæknadeild,Doktorspróf,1,1,2
1809,2021,"Deild erlendra tungumála, bókmennta og málvísinda",,263,572,835
1810,2021,"Deild erlendra tungumála, bókmennta og málvísinda",Grunnnám,230,479,709
1811,2021,"Deild erlendra tungumála, bókmennta og málvísinda",Viðbótarnám,0,0,0
1812,2021,"Deild erlendra tungumála, bókmennta og málvísinda",Meistarapróf,28,80,108
1813,2021,"Deild erlendra tungumála, bókmennta og málvísinda",Doktorspróf,5,13,18
1814,2021,Guðfræði- og trúarbragðafræðideild,,37,33,70
1815,2021,Guðfræði- og trúarbragðafræðideild,Grunnnám,23,22,45
1816,2021,Guðfræði- og trúarbragðafræðideild,Viðbótarnám,1,1,2
1817,2021,Guðfræði- og trúarbragðafræðideild,Meistarapróf,12,10,22
1818,2021,Guðfræði- og trúarbragðafræðideild,Doktorspróf,1,0,1
1819,2021,Íslensku- og menningardeild,,318,802,1120
1820,2021,Íslensku- og menningardeild,Grunnnám,183,524,707
1821,2021,Íslensku- og menningardeild,Viðbótarnám,2,6,8
1822,2021,Íslensku- og menningardeild,Meistarapróf,101,234,335
1823,2021,Íslensku- og menningardeild,Doktorspróf,32,38,70
1824,2021,Sagnfræði- og heimspekideild,,317,268,585
1825,2021,Sagnfræði- og heimspekideild,Grunnnám,179,100,279
1826,2021,Sagnfræði- og heimspekideild,Viðbótarnám,18,43,61
1827,2021,Sagnfræði- og heimspekideild,Meistarapróf,90,100,190
1828,2021,Sagnfræði- og heimspekideild,Doktorspróf,30,25,55
1829,2021,"Íþrótta-, tómstunda- og þroskaþjálfadeild",,224,347,571
1830,2021,"Íþrótta-, tómstunda- og þroskaþjálfadeild",Grunnnám,176,217,393
1831,2021,"Íþrótta-, tómstunda- og þroskaþjálfadeild",Viðbótarnám,25,90,115
1832,2021,"Íþrótta-, tómstunda- og þroskaþjálfadeild",Meistarapróf,23,40,63
1833,2021,"Íþrótta-, tómstunda- og þroskaþjálfadeild",Doktorspróf,0,0,0
1834,2021,Kennaradeild,,328,1567,1895
1835,2021,Kennaradeild,Grunnnám,167,643,810
1836,2021,Kennaradeild,Viðbótarnám,100,633,733
1837,2021,Kennaradeild,Meistarapróf,61,291,352
1838,2021,Kennaradeild,Doktorspróf,0,0,0
1839,2021,Uppeldis- og menntunarfræðideild,,96,662,758
1840,2021,Uppeldis- og menntunarfræðideild,Grunnnám,41,358,399
1841,2021,Uppeldis- og menntunarfræðideild,Viðbótarnám,3,38,41
1842,2021,Uppeldis- og menntunarfræðideild,Meistarapróf,36,216,252
1843,2021,Uppeldis- og menntunarfræðideild,Doktorspróf,16,50,66
1844,2021,"Iðnaðarverkfræði-, vélaverkfræði- og tölvunarfræðideild",,632,255,887
1845,2021,"Iðnaðarverkfræði-, vélaverkfræði- og tölvunarfræðideild",Grunnnám,495,216,711
1846,2021,"Iðnaðarverkfræði-, vélaverkfræði- og tölvunarfræðideild",Viðbótarnám,0,0,0
1847,2021,"Iðnaðarverkfræði-, vélaverkfræði- og tölvunarfræðideild",Meistarapróf,118,30,148
1848,2021,"Iðnaðarverkfræði-, vélaverkfræði- og tölvunarfræðideild",Doktorspróf,19,9,28
1849,2021,Jarðvísindadeild,,71,124,195
1850,2021,Jarðvísindadeild,Grunnnám,34,45,79
1851,2021,Jarðvísindadeild,Viðbótarnám,0,0,0
1852,2021,Jarðvísindadeild,Meistarapróf,29,65,94
1853,2021,Jarðvísindadeild,Doktorspróf,8,14,22
1854,2021,Líf- og umhverfisvísindadeild,,161,300,461
1855,2021,Líf- og umhverfisvísindadeild,Grunnnám,104,205,309
1856,2021,Líf- og umhverfisvísindadeild,Viðbótarnám,0,0,0
1857,2021,Líf- og umhverfisvísindadeild,Meistarapróf,41,64,105
1858,2021,Líf- og umhverfisvísindadeild,Doktorspróf,16,31,47
1859,2021,Rafmagns- og tölvuverkfræðideild,,153,33,186
1860,2021,Rafmagns- og tölvuverkfræðideild,Grunnnám,141,28,169
1861,2021,Rafmagns- og tölvuverkfræðideild,Viðbótarnám,0,0,0
1862,2021,Rafmagns- og tölvuverkfræðideild,Meistarapróf,9,4,13
1863,2021,Rafmagns- og tölvuverkfræðideild,Doktorspróf,3,1,4
1864,2021,Raunvísindadeild,,257,197,454
1865,2021,Raunvísindadeild,Grunnnám,164,156,320
1866,2021,Raunvísindadeild,Viðbótarnám,0,0,0
1867,2021,Raunvísindadeild,Meistarapróf,52,24,76
1868,2021,Raunvísindadeild,Doktorspróf,41,17,58
1869,2021,Umhverfis- og byggingaverkfræðideild,,100,90,190
1870,2021,Umhverfis- og byggingaverkfræðideild,Grunnnám,55,61,116
1871,2021,Umhverfis- og byggingaverkfræðideild,Viðbótarnám,0,0,0
1872,2021,Umhverfis- og byggingaverkfræðideild,Meistarapróf,38,23,61
1873,2021,Umhverfis- og byggingaverkfræðideild,Doktorspróf,7,6,13
